middle	miđle
addition	ađition
added	ađed
additional	ađitional
add	ađ
address	ảđe
suddenly	suđenly
addressed	ảđeed
sudden	suđen
adding	ađing
hidden	hiđen
nodded	nođed
odd	ođ
wedding	weđing
adds	áđ
addresses	ảđee
embedded	embeđed
buddhist	búđhit
addressing	ảđeing
buddha	buđha
forbidden	forbiđen
goddess	gođe
bladder	blađẻ
odds	óđ
buddhism	búđhim
daddy	đady
additionally	ađitionally
ladder	lađẻ
saddle	sađle
additions	áđition
addiction	ađiction
eddie	eđie
todd	tođ
addison	áđion
bidding	biđing
additive	ađitive
buddy	buđy
eddy	eđy
muddy	muđy
paddy	pađy
ridden	riđen
reddish	ređíh
oddly	ođly
teddy	teđy
yiddish	yíđih
bedding	beđing
saddam	sađam
forbidding	forbiđing
nodding	nođing
additives	áđitive
riddle	riđle
dd	đ
middleton	miđleton
fodder	fođẻ
addicts	áđict
midday	miđay
shedding	sheđing
pudding	puđing
paddle	pađle
huddled	huđled
buddhists	búđhit
addicted	ađicted
dodd	đod
goddesses	gođée
kidding	kiđing
weddings	wéđing
granddaughter	granđảughte
ddt	đt
budding	buđing
shuddered	shuđẻed
addict	ađict
embedding	embeđing
shudder	shuđẻ
padded	pađed
gallbladder	gallblảđe
bidder	biđẻ
toddler	tođlẻ
middlesex	miđlée
goddard	gođảd
fiddle	fiđle
goddamn	gođamn
rudder	ruđẻ
freddie	fređie
toddlers	tođlẻ
studded	stuđed
ladders	lađẻ
addictive	ađictive
shredded	shređed
judd	juđ
reddy	ređy
adduced	ađuced
wedded	weđed
buddies	búđie
addis	áđi
addressee	ảđeê
padding	pađing
riddles	riđlé
giddens	gíđen
buddhas	búđha
bedded	beđed
middlemen	miđlemen
saddled	sađled
ruddy	ruđy
freddy	fređy
madden	mađen
biddle	biđle
hodder	hođẻ
riddled	riđled
kidd	kiđ
saddles	sađlé
bidders	biđẻ
puddle	puđle
giddy	giđy
adder	ađẻ
eddies	eđíe
saddened	sađened
middletown	miđletơn
cladding	clađing
budd	buđ
addams	áđam
imbedded	imbeđed
prodded	prođed
ladd	lađ
trodden	trođen
muddled	muđled
meddling	međling
muddle	muđle
addendum	ađendum
shuddering	shuđẻing
stoddard	stođảd
middleclass	miđlécla
geddes	geđé
reddened	ređened
addictions	áđiction
ddr	đr
paddling	pađling
headdress	heảđe
maddox	mãđo
prodding	prođing
paddock	pađock
cheddar	cheđả
paddles	pađlé
adductor	ảđucto
middling	miđling
huddle	huđle
overridden	oveiđen
fiddler	fiđlẻ
meddle	međle
liddell	liđell
sodden	sođen
middleman	miđleman
puddles	puđlé
suddenness	suđénne
braddock	brađock
straddle	strađle
oddity	ođity
paddled	pađled
peddlers	peđlẻ
maddening	mađening
thaddeus	thađéu
shoddy	shođy
adduction	ađuction
waddell	wađell
downtrodden	đởntoden
dodds	đód
peddler	peđlẻ
armageddon	ảmageđon
midden	miđen
goddamned	gođamned
straddling	strađling
saddest	sađét
plodding	plođing
rudd	ruđ
addie	ađie
redding	ređing
middleware	miđlẻwae
fiddling	fiđling
kidder	kiđẻ
peddling	peđling
mcfadden	mcfađen
aladdin	alađin
waddington	wađington
maddie	mađie
paddington	pađington
oddities	óđitie
eddington	eđington
ridding	riđing
maddy	mađy
haddock	hađock
caddy	cađy
skidded	skiđed
goddam	gođam
bidden	biđen
hedda	heđa
giddings	gíđing
sadder	sađẻ
sadducees	sáđucê
straddled	strađled
bedridden	bẻđiden
reddening	ređening
puddings	púđing
adduce	ađuce
dde	đe
adducts	áđuct
scudder	scuđẻ
adduct	ađuct
udder	uđẻ
madder	mađẻ
haddon	hađon
haddad	hađad
embeddedness	embéđedne
maddened	mađened
addr	ảđ
addenda	ađenda
riddell	riđell
addington	ađington
buddhahood	buđhahôd
mudd	muđ
paddies	páđie
skidding	skiđing
siddhartha	sỉđhatha
seddon	seđon
interbedded	intẻbeđed
ddc	đc
roddy	rođy
edd	eđ
biddy	biđy
redder	ređẻ
toddy	tođy
plodded	plođed
bladders	blađẻ
unbidden	unbiđen
additivity	ađitivity
buddhi	buđhi
baddeley	bađeley
gladden	glađen
dds	đs
addressees	ảđeê
weddell	weđell
cuddled	cuđled
cuddle	cuđle
middleaged	miđleaged
tcdd	tcđ
shudders	shuđẻ
middlemarch	miđlẻmach
jeddah	jeđah
dda	đa
laddie	lađie
edda	eđa
fiddled	fiđled
gaddis	gáđi
thudding	thuđing
oddest	ođét
megiddo	megiđo
straddles	strađlé
cuddling	cuđling
craddock	crađock
liddy	liđy
headdresses	heảđee
huddersfield	huđẻield
middlebury	miđlẻbuy
shredding	shređing
giddiness	giđíne
swidden	swiđen
ddd	đd
siddons	síđon
ddl	đl
addressable	ảđeable
stoddart	stođảt
ridder	riđẻ
qaddafi	qađài
griddle	griđle
swaddling	swađling
befuddled	bèuđled
wedderburn	weđẻbun
iddm	iđm
middens	míđen
huddleston	huđléton
kaddish	káđih
granddaughters	granđảughte
maddison	máđion
dinwiddie	đinwidie
adders	ađẻ
caddo	cađo
granddad	granđad
niddm	niđm
hadden	hađen
peddle	peđle
fiddlers	fiđlẻ
lidded	liđed
paddocks	páđock
huddling	huđling
siddha	siđha
saddlebags	sađlébag
muddling	muđling
tdd	tđ
addi	ađi
fiddles	fiđlé
caddie	cađie
muddied	muđied
liddle	liđle
peddled	peđled
kiddie	kiđie
waddled	wađled
cuddly	cuđly
redd	ređ
granddaddy	granđađy
wadding	wađing
buddhistic	búđhitic
siddhanta	siđhanta
addisonwesley	áđiơneley
gwynedd	gwyneđ
thudded	thuđed
irrawaddy	ỉrăađy
addy	ađy
riddance	riđance
codd	cođ
adduces	áđuce
uddi	uđi
ddp	đp
wadded	wađed
widdowson	wiđớon
redden	ređen
maddalena	mađalena
tedder	teđẻ
vdd	vđ
gladdened	glađened
addled	ađled
caddis	cáđi
feddans	féđan
saddler	sađlẻ
paddlers	pađlẻ
siddhi	siđhi
soddy	sođy
goddammit	gođammit
rudders	ruđẻ
reddi	ređi
swaddled	swađled
vedder	veđẻ
budded	buđed
waddling	wađling
pdd	pđ
puddling	puđling
middles	miđlé
wadden	wađen
meddlesome	međléome
bdd	bđ
middelburg	miđẻlbug
sledding	sleđing
maddeningly	mađeningly
middlesbrough	miđlébough
oddball	ođball
kiddush	kíđuh
adda	ađa
maddock	mađock
rodd	rođ
kidded	kiđed
twaddle	twađle
kiddies	kiđíe
beddoes	béđoe
spedding	speđing
mdd	mđ
hadde	hađe
rhondda	rhonđa
kiddo	kiđo
saddling	sađling
waddle	wađle
noddings	nóđing
meddled	međled
gaddi	gađi
eddying	eđying
unaddressed	ủnađeed
ddi	đi
siddiqui	siđiqui
coddled	cođled
gridded	griđed
oddi	ođi
superadded	supẻađed
shredder	shređẻ
coddling	cođling
untrodden	ủntođen
boddy	bođy
odder	ođẻ
adducing	ađucing
madding	mađing
scudding	scuđing
glidden	gliđen
coddington	cođington
shedd	sheđ
stepladder	steplảđe
taddeo	tađeo
riddling	riđling
diddle	đidle
udders	uđẻ
middlebrook	mỉđlebôk
godden	gođen
caddies	cáđie
medd	međ
ruddick	ruđick
puddled	puđled
adderley	ađẻley
saddlebag	sađlebag
haddington	hađington
daddies	đádie
cuddy	cuđy
quiddity	quiđity
fludd	fluđ
adductors	ảđucto
luddites	lúđite
keddie	keđie
sraddha	srađha
heddle	heđle
oddness	ođne
braddon	brađon
doddridge	đỏdidge
lydda	lyđa
studding	stuđing
adducted	ađucted
dafydd	đàyd
additively	ađitively
middlebrow	mỉđlebơ
macfadden	màcađen
addend	ađend
biddulph	biđulph
addicting	ađicting
alauddin	alauđin
siddiqi	siđiqi
teddington	teđington
gidding	giđing
buddhaghosa	buđhághoa
hiddenness	hiđénne
khaddar	khađả
luddite	luđite
saddening	sađening
siddhas	síđha
cuddapah	cuđapah