# English 100k Typing Variants
# Format: word TAB variant1,variant2,...
# Generated by english_telex_patterns_test.rs

been	beeen,been
see	seee,see
between	between
how	howw,how
now	noww,now
however	howwever,however
own	own
three	three
good	goood,good
down	dowwn,down
know	know
too	tooo,too
power	powwer,power
law	laww,law
need	neeed,need
school	school
following	following
book	boook,book
away	away
known	known
seen	seeen,seen
took	toook,took
free	free
look	loook,look
low	loww,low
knowledge	knowledge
room	rooom,room
show	show
shown	shown
growth	growth
toward	towward,toward
saw	saww,saw
food	food
seems	seeems,seems
lower	lowwer,lower
keep	keeep,keep
looked	loooked,looked
blood	blood
feel	feel
needs	neeeds,needs
soon	sooon,soon
middle	midddle,middle
indeed	indeed
books	boooks,books
addition	addition
seemed	seeemed,seemed
below	beloww,below
committee	committeee,committee
needed	neeeded,needed
shows	shows
poor	pooor,poor
town	towwn,town
seem	seeem,seem
followed	followed
door	dooor,door
looking	loooking,looking
degree	degreee,degree
street	street
feet	feet
added	added
schools	schools
flow	flow
meeting	meeeting,meeting
towards	towwards,towards
follow	follow
deep	deeep,deep
agreement	agreement
laws	lawws,laws
additional	additional
freedom	freedom
meet	meeet,meet
week	week
green	green
feeling	feeling
follows	follows
allow	allow
speech	speech
allowed	allowed
goods	gooods,goods
brown	brown
add	add
address	address
growing	growing
stood	stood
showed	showed
weeks	weeks
floor	floor
powers	powwers,powers
tree	treee,tree
window	window
speed	speed
employees	employees
powerful	powwerful,powerful
agreed	agreed
trees	treees,trees
understood	understood
aware	aware
drawn	drawn
wood	wood
foot	foot
choose	chooose,choose
suddenly	sudddenly,suddenly
feelings	feelings
career	careeer,career
sleep	sleep
slowly	slowly
knows	knows
showing	showing
steel	steel
greek	greek
seek	seeek,seek
engineering	engineering
slow	slow
windows	windows
allows	allows
drawing	drawing
grow	grow
tools	toools,tools
draw	draw
seeing	seeeing,seeing
troops	trooops,troops
looks	loooks,looks
agree	agree
keeping	keeeping,keeping
nineteenth	nineteeenth,nineteenth
queen	queeen,queen
knowing	knowing
employee	employee
narrow	narroww,narrow
proceedings	proceedings
yellow	yelloww,yellow
unknown	unknown
owner	owner
screen	screen
fellow	fellow
root	rooot,root
grown	grown
tool	toool,tool
proof	proof
cooperation	coooperation,cooperation
meetings	meeetings,meetings
seeking	seeeking,seeking
degrees	degreees,degrees
afternoon	afternoon
row	roww,row
sheet	sheet
owned	owned
lee	leee,lee
flowers	flowers
rooms	roooms,rooms
awareness	awareness
coffee	coffeee,coffee
childhood	childhoood,childhood
moon	mooon,moon
deeply	deeeply,deeply
streets	streets
towns	towwns,towns
teeth	teeeth,teeth
roots	rooots,roots
snow	snow
sweet	sweet
fifteen	fifteen
sees	seees,sees
addressed	addressed
raw	raww,raw
ownership	ownership
sudden	suddden,sudden
adding	adding
hidden	hiddden,hidden
crown	crown
owners	owners
allowing	allowing
smooth	smooth
feed	feed
crowd	crowd
moscow	moscoww,moscow
classroom	classroom
cool	coool,cool
somehow	somehoww,somehow
cook	coook,cook
seed	seeed,seed
succeeded	succeeeded,succeeded
feels	feels
eighteenth	eighteeenth,eighteenth
pool	poool,pool
agreements	agreements
doors	dooors,doors
shook	shook
lawyer	lawwyer,lawyer
flows	flows
roof	rooof,roof
proceed	proceed
feeding	feeding
foods	foods
tomorrow	tomorroww,tomorrow
lawrence	lawwrence,lawrence
mood	moood,mood
shadow	shadow
loose	looose,loose
loop	looop,loop
feedback	feedback
throw	throw
lowest	lowwest,lowest
wooden	wooden
nodded	noddded,nodded
weekly	weekly
fee	fee
deeper	deeeper,deeper
woods	woods
roosevelt	rooosevelt,roosevelt
fees	fees
tower	towwer,tower
engineers	engineers
wheel	wheel
award	award
sheep	sheep
creek	creek
blow	blow
flower	flower
neighborhood	neighborhoood,neighborhood
cooperative	coooperative,cooperative
seeds	seeeds,seeds
thrown	thrown
howard	howward,howard
committees	committeees,committees
odd	odd
freely	freely
guarantee	guaranteee,guarantee
fleet	fleet
thee	theee,thee
moore	mooore,moore
engineer	engineer
lawyers	lawwyers,lawyers
wedding	wedding
greece	greece
beer	beeer,beer
succeed	succeeed,succeed
sleeping	sleeping
adds	adds
addresses	addresses
proceeds	proceeds
choosing	chooosing,choosing
acknowledged	acknowledged
sheets	sheets
withdrawal	withdrawal
deemed	deeemed,deemed
keeps	keeeps,keeps
powder	powwder,powder
owing	owing
flood	flood
handbook	handboook,handbook
cooking	coooking,cooking
exceed	exceed
seeks	seeeks,seeks
followers	followers
seventeenth	seventeeenth,seventeenth
bowl	bowwl,bowl
dawn	dawwn,dawn
coordination	cooordination,coordination
knees	knees
eighteen	eighteeen,eighteen
acknowledge	acknowledge
drawings	drawings
fourteen	fourteen
bedroom	bedrooom,bedroom
grows	grows
bow	boww,bow
knee	knee
rows	rowws,rows
sixteen	sixteeen,sixteen
likelihood	likelihoood,likelihood
proceeded	proceeded
bleeding	bleeding
shallow	shallow
cooling	coooling,cooling
outlook	outloook,outlook
breeding	breeding
arrow	arrow
shoot	shoot
cheese	cheeese,cheese
proceeding	proceeding
shooting	shooting
screening	screening
peer	peeer,peer
seemingly	seeemingly,seemingly
asleep	asleep
football	football
thirteen	thirteeen,thirteen
poorly	pooorly,poorly
nowhere	nowwhere,nowhere
needle	neeedle,needle
breakdown	breakdown
speeches	speeches
esteem	esteem
sooner	soooner,sooner
fool	fool
flowing	flowing
sixteenth	sixteeenth,sixteenth
cooper	coooper,cooper
shadows	shadows
refugees	refugeees,refugees
tennessee	tennesseee,tennessee
coordinate	cooordinate,coordinate
embedded	embedded
buddhist	budddhist,buddhist
meets	meeets,meets
decree	decreee,decree
volunteers	volunteeers,volunteers
draws	draws
lowered	lowwered,lowered
crowded	crowded
deer	deeer,deer
widow	widow
addressing	addressing
buddha	budddha,buddha
awarded	awarded
guaranteed	guaranteeed,guaranteed
iowa	iowwa,iowa
wool	wool
cow	coww,cow
downward	dowwnward,downward
bloody	bloody
hollywood	hollywood
peers	peeers,peers
goodness	gooodness,goodness
deeds	deeeds,deeds
tooth	toooth,tooth
greeks	greeks
allowance	allowance
rooted	roooted,rooted
forbidden	forbidden
borrowed	borrowwed,borrowed
shaw	shaw
steep	steep
throwing	throwing
hollow	holloww,hollow
deed	deeed,deed
keen	keeen,keen
beef	beeef,beef
goddess	godddess,goddess
bladder	bladder
withdraw	withdraw
sheer	sheer
reed	reeed,reed
sorrow	sorroww,sorrow
wheels	wheels
noon	nooon,noon
boots	booots,boots
volunteer	volunteeer,volunteer
weekend	weekend
cheek	cheeek,cheek
odds	odds
trustee	trusteee,trustee
awards	awards
seventeen	seventeeen,seventeen
isaac	isaac
schooling	schooling
buddhism	budddhism,buddhism
coordinates	cooordinates,coordinates
exceeds	exceeds
boom	booom,boom
withdrawn	withdrawn
careers	careeers,careers
awful	awful
pioneer	pioneeer,pioneer
trustees	trusteees,trustees
cooked	coooked,cooked
mcgraw	mcgraw
arrows	arrows
ieee	ieeee,ieee
hook	hoook,hook
bathroom	bathrooom,bathroom
fourteenth	fourteenth
awake	awake
foolish	foolish
owe	owe
freed	freed
owed	owed
hawaii	hawwaii,hawaii
aa	aaa,aa
straw	straw
cheeks	cheeeks,cheeks
daddy	dadddy,daddy
exceeded	exceeded
borrowing	borrowwing,borrowing
agrees	agrees
outdoor	outdooor,outdoor
cows	cowws,cows
additionally	additionally
eisenhower	eisenhowwer,eisenhower
bloom	bloom
downtown	dowwntowwn,downtown
ladder	laddder,ladder
fellows	fellows
fellowship	fellowship
powell	powwell,powell
slower	slower
manpower	manpowwer,manpower
hood	hoood,hood
fifteenth	fifteenth
overlooked	overlooked
shower	shower
exceeding	exceeding
owen	owen
doorway	dooorway,doorway
breed	breed
floors	floors
jaw	jaw
guarantees	guaranteees,guarantees
blown	blown
textbook	textboook,textbook
saddle	sadddle,saddle
marrow	marroww,marrow
brooks	brooks
freezing	freezing
elbow	elbow
unaware	unaware
nineteen	nineteeen,nineteen
freeman	freeman
lowering	lowwering,lowering
speeds	speeds
borrow	borroww,borrow
sweep	sweep
greeted	greeted
disagreement	disagreeement,disagreement
additions	additions
towers	towwers,towers
disagree	disagreee,disagree
sweeping	sweeping
booth	boooth,booth
blowing	blowing
bowel	bowwel,bowel
coordinated	cooordinated,coordinated
thirteenth	thirteeenth,thirteenth
awkward	awkward
glow	glow
crowds	crowds
succeeding	succeeeding,succeeding
breeze	breeze
lawn	lawwn,lawn
delaware	delawware,delaware
cooperate	coooperate,cooperate
chooses	choooses,chooses
warsaw	warsaw
teaspoon	teaspooon,teaspoon
glasgow	glasgow
freeze	freeze
morrow	morroww,morrow
textbooks	textboooks,textbooks
exceedingly	exceedingly
ottawa	ottawa
heels	heeels,heels
bee	beee,bee
steering	steering
endowed	endowed
nowadays	nowwadays,nowadays
poorer	pooorer,poorer
brooklyn	brooklyn
boot	booot,boot
swallowed	swallowed
allowances	allowances
hoover	hooover,hoover
liverpool	liverpoool,liverpool
neighbourhood	neighbourhoood,neighbourhood
pools	poools,pools
refugee	refugeee,refugee
deepest	deeepest,deepest
greene	greene
neighborhoods	neighborhooods,neighborhoods
aaron	aaaron,aaron
loops	looops,loops
balloon	ballooon,balloon
flowering	flowering
loosely	looosely,loosely
vowel	vowwel,vowel
blows	blows
creed	creed
cooled	coooled,cooled
downstream	dowwnstream,downstream
smoothly	smoothly
addiction	addiction
cheerful	cheeerful,cheerful
owns	owns
footnote	footnote
classrooms	classrooms
awakening	awakening
bowed	bowwed,bowed
microwave	microwwave,microwave
crow	crow
swallow	swallow
township	towwnship,township
weed	weed
undertook	undertook
bees	beees,bees
tablespoons	tablespooons,tablespoons
throws	throws
browser	browser
creep	creep
weeds	weeds
lawful	lawwful,lawful
screens	screens
brotherhood	brotherhood
pillow	pilloww,pillow
notebook	noteboook,notebook
seeming	seeeming,seeming
awe	awe
reef	reeef,reef
brow	brow
downstairs	dowwnstairs,downstairs
adulthood	adulthood
pioneers	pioneeers,pioneers
powered	powwered,powered
acknowledgments	acknowledgments
slowed	slowed
awaiting	awaiting
awakened	awakened
agreeable	agreeable
gown	gowwn,gown
proofs	proofs
doomed	dooomed,doomed
howe	howwe,howe
heel	heeel,heel
englewood	englewood
eddie	eddie
flowed	flowed
overthrow	overthrow
drawer	drawer
teenagers	teeenagers,teenagers
unlawful	unlawful
rainbow	rainboww,rainbow
brook	brook
todd	toddd,todd
crawford	crawford
goodwill	gooodwill,goodwill
stool	stool
worksheet	worksheet
hawk	hawwk,hawk
greeting	greeting
footsteps	footsteps
landowners	landowwners,landowners
squeezed	squeezed
peel	peeel,peel
spoon	spoon
microorganisms	microoorganisms,microorganisms
frowned	frowned
needless	neeedless,needless
beethoven	beeethoven,beethoven
bamboo	bambooo,bamboo
coordinating	cooordinating,coordinating
needles	neeedles,needles
glowing	glowing
wheeler	wheeler
meadow	meadoww,meadow
goodman	gooodman,goodman
milwaukee	milwaukeee,milwaukee
cooperatives	coooperatives,cooperatives
weeping	weeping
troop	trooop,troop
addison	addison
drowned	drowned
spleen	spleen
greenhouse	greenhouse
narrowly	narrowwly,narrowly
greed	greed
squeeze	squeeze
queer	queeer,queer
acknowledgment	acknowledgment
feeble	feeble
towel	towwel,towel
empowered	empowered
boost	booost,boost
teenage	teeenage,teenage
needing	neeeding,needing
feeds	feeds
oo	ooo,oo
sleeve	sleeve
owes	owes
teen	teeen,teen
endowment	endowment
teens	teeens,teens
subcommittee	subcommitteee,subcommittee
flee	flee
roofs	rooofs,roofs
floods	floods
acknowledges	acknowledges
keeper	keeeper,keeper
lowell	lowwell,lowell
bidding	biddding,bidding
knowledgeable	knowledgeable
yearbook	yearboook,yearbook
renowned	renowwned,renowned
browning	browning
goodbye	gooodbye,goodbye
preschool	preschool
footing	footing
eyebrows	eyebrowws,eyebrows
acknowledging	acknowledging
coordinator	cooordinator,coordinator
crowned	crowned
shoots	shoots
eec	eeec,eec
flooded	flooded
additive	additive
flooding	flooding
overlooking	overlooking
await	await
kuwait	kuwwait,kuwait
narrowed	narrowwed,narrowed
empowerment	empowerment
livelihood	livelihoood,livelihood
goose	gooose,goose
weekends	weekends
unseen	unseen
meadows	meadowws,meadows
narrower	narrowwer,narrower
allowable	allowable
powerless	powwerless,powerless
freedoms	freedoms
hawthorne	hawwthorne,hawthorne
woodland	woodland
overlook	overlook
agreeing	agreeing
greet	greet
gloomy	gloomy
moonlight	mooonlight,moonlight
awaited	awaited
owl	owl
yankee	yankeee,yankee
groove	groove
indoor	indoor
acknowledgements	acknowledgements
cookies	coookies,cookies
widows	widows
buddy	budddy,buddy
vowels	vowwels,vowels
pioneering	pioneeering,pioneering
flown	flown
jaws	jaws
bestowed	bestowwed,bestowed
decrees	decreees,decrees
owning	owning
boolean	booolean,boolean
eddy	eddy
cheer	cheeer,cheer
bowls	bowwls,bowls
muddy	mudddy,muddy
manhood	manhoood,manhood
zoo	zoo
queens	queeens,queens
moods	mooods,moods
toolbar	tooolbar,toolbar
dawson	dawwson,dawson
downs	dowwns,downs
willow	willow
growers	growers
cooler	coooler,cooler
kathleen	kathleeen,kathleen
greenwood	greenwood
hawaiian	hawwaiian,hawaiian
borrower	borrowwer,borrower
gloom	gloom
poorest	pooorest,poorest
breeds	breeds
queensland	queeensland,queensland
greens	greens
priesthood	priesthood
hawkins	hawwkins,hawkins
motherhood	motherhoood,motherhood
paddy	padddy,paddy
cowboy	cowwboy,cowboy
seedlings	seeedlings,seedlings
groom	groom
fools	fools
reel	reeel,reel
ridden	riddden,ridden
succeeds	succeeeds,succeeds
reddish	redddish,reddish
courtroom	courtrooom,courtroom
heed	heeed,heed
misunderstood	misunderstoood,misunderstood
mushrooms	mushroooms,mushrooms
bloomington	bloomington
tablespoon	tablespooon,tablespoon
fowler	fowler
moody	mooody,moody
hooks	hoooks,hooks
narrowing	narrowwing,narrowing
doom	dooom,doom
ee	eee,ee
sleeves	sleeves
woody	woody
cartoon	cartooon,cartoon
slowing	slowing
steer	steer
volunteered	volunteeered,volunteered
oddly	oddly
dow	doww,dow
peered	peeered,peered
vow	voww,vow
awoke	awoke
eeg	eeeg,eeg
brooke	brooke
needy	neeedy,needy
outdoors	outdooors,outdoors
hooked	hoooked,hooked
booklet	boooklet,booklet
browne	browne
disagreed	disagreeed,disagreed
anyhow	anyhow
outflow	outfloww,outflow
sweetness	sweetness
bows	bowws,bows
crawl	crawl
weep	weep
teenager	teeenager,teenager
lawsuit	lawwsuit,lawsuit
steele	steele
cherokee	cherokeee,cherokee
flaws	flaws
screened	screened
steels	steels
leeds	leeeds,leeds
powerfully	powwerfully,powerfully
sown	sowwn,sown
greenland	greenland
greenwich	greenwich
swallowing	swallowing
disagreements	disagreeements,disagreements
follower	follower
creeping	creeping
dee	deee,dee
awhile	awhile
vows	vowws,vows
woolf	woolf
teddy	tedddy,teddy
taboo	tabooo,taboo
hooker	hoooker,hooker
speedy	speedy
elbows	elbows
crawled	crawled
footnotes	footnotes
fleeing	fleeing
withdrawing	withdrawing
acknowledgement	acknowledgement
overflow	overflow
yiddish	yidddish,yiddish
bedding	beddding,bedding
inflow	inflow
crooked	crooked
rupees	rupeees,rupees
woodward	woodward
greedy	greedy
deepening	deeepening,deepening
cooke	coooke,cooke
coward	cowward,coward
seekers	seeekers,seekers
drowning	drowning
sleepy	sleepy
spreadsheet	spreadsheet
lawson	lawwson,lawson
kneeling	kneeling
powdered	powwdered,powdered
greenberg	greenberg
wheelchair	wheelchair
download	dowwnload,download
saddam	sadddam,saddam
showers	showers
cheerfully	cheeerfully,cheerfully
saloon	salooon,saloon
crawling	crawling
downwards	dowwnwards,downwards
foodstuffs	foodstuffs
sow	soww,sow
fleeting	fleeting
drawers	drawers
cookie	coookie,cookie
bowen	bowwen,bowen
crowns	crowns
lessee	lesseee,lessee
bowling	bowwling,bowling
wee	wee
trainees	traineees,trainees
bedrooms	bedroooms,bedrooms
loom	looom,loom
ooo	oooo,ooo
awaken	awaken
engineered	engineered
redeemed	redeeemed,redeemed
awesome	awesome
platoon	platoon
smoothing	smoothing
foreseen	foreseen
forbidding	forbidding
soothing	sooothing,soothing
aberdeen	aberdeen
wooded	wooded
nodding	noddding,nodding
wheeled	wheeled
smoothed	smoothed
claws	claws
crowding	crowding
peeled	peeeled,peeled
jeep	jeep
additives	additives
flaw	flaw
townsend	towwnsend,townsend
riddle	ridddle,riddle
decreed	decreeed,decreed
tow	toww,tow
dd	dd
deepened	deeepened,deepened
reefs	reeefs,reefs
freeing	freeing
aw	aw
lagoon	lagooon,lagoon
keenly	keeenly,keenly
greetings	greetings
geese	geeese,geese
howell	howwell,howell
esteemed	esteemed
yellowish	yellowwish,yellowish
tee	teee,tee
beetle	beeetle,beetle
drawbacks	drawbacks
yankees	yankeees,yankees
flawed	flawed
towering	towwering,towering
towels	towwels,towels
shadowy	shadowy
downfall	dowwnfall,downfall
borrowers	borrowwers,borrowers
georgetown	georgetowwn,georgetown
plywood	plywood
kierkegaard	kierkegaaard,kierkegaard
indoors	indoors
cooks	coooks,cooks
seafood	seafoood,seafood
lowland	lowwland,lowland
moor	mooor,moor
deem	deeem,deem
woodrow	woodrow
lowe	lowwe,lowe
sowing	sowwing,sowing
newsweek	newsweek
housekeeping	housekeeeping,housekeeping
middleton	midddleton,middleton
aloof	aloof
drawback	drawback
foreseeable	foreseeable
frown	frown
sorrows	sorrowws,sorrows
fodder	fodder
pooled	poooled,pooled
disagreeable	disagreeeable,disagreeable
landowner	landowwner,landowner
workbook	workbook
mushroom	mushrooom,mushroom
widowed	widowed
evergreen	evergreen
beetles	beeetles,beetles
knowingly	knowingly
falsehood	falsehood
lowers	lowwers,lowers
wow	wow
runaway	runawway,runaway
coworkers	cowworkers,coworkers
cartoons	cartooons,cartoons
addicts	addicts
discreet	discreeet,discreet
notebooks	noteboooks,notebooks
foresee	foresee
feeder	feeder
rowe	rowwe,rowe
barrow	barroww,barrow
brood	brood
transvaal	transvaaal,transvaal
naacp	naaacp,naacp
sweetheart	sweetheart
devotees	devoteees,devotees
sparrow	sparrow
midday	middday,midday
clown	clown
redeem	redeeem,redeem
parenthood	parenthoood,parenthood
pillows	pillowws,pillows
peering	peeering,peering
licensee	licenseee,licensee
shedding	shedding
cheered	cheeered,cheered
goodwin	gooodwin,goodwin
speeding	speeding
gaas	gaaas,gaas
housekeeper	housekeeeper,housekeeper
pudding	puddding,pudding
monsoon	monsooon,monsoon
browse	browse
boon	booon,boon
paddle	padddle,paddle
moose	mooose,moose
broom	broom
plow	plow
dowry	dowwry,dowry
jubilee	jubilee
grassroots	grassroots
zoom	zoom
kluwer	kluwer
huddled	hudddled,huddled
cooperating	coooperating,cooperating
lookout	loookout,lookout
strawberry	strawberry
vowed	vowwed,vowed
owens	owens
buddhists	budddhists,buddhists
powders	powwders,powders
bowman	bowwman,bowman
boyhood	boyhoood,boyhood
prowess	prowess
addicted	addicted
freer	freer
lowlands	lowwlands,lowlands
een	eeen,een
fowl	fowl
crook	crook
cheers	cheeers,cheers
speedily	speedily
galilee	galileee,galilee
grooves	grooves
seawater	seawwater,seawater
dodd	doddd,dodd
bookstore	boookstore,bookstore
waterloo	waterloo
bleed	bleed
keepers	keeepers,keepers
lawsuits	lawwsuits,lawsuits
sawyer	sawwyer,sawyer
honeymoon	honeymooon,honeymoon
womanhood	womanhood
cheering	cheeering,cheering
drown	drown
nee	neee,nee
stools	stools
afternoons	afternoons
brows	brows
barlow	barloww,barlow
aaa	aaaa,aaa
rawls	rawwls,rawls
pharisees	phariseees,pharisees
pooling	poooling,pooling
firewood	firewood
boone	booone,boone
goddesses	godddesses,goddesses
freedman	freedman
looms	loooms,looms
brookings	brookings
growled	growled
moors	mooors,moors
bridegroom	bridegroom
kidding	kiddding,kidding
downhill	dowwnhill,downhill
sweets	sweets
loosen	looosen,loosen
seeker	seeeker,seeker
beech	beeech,beech
bloodshed	bloodshed
hawks	hawwks,hawks
sleeps	sleeps
pioneered	pioneeered,pioneered
brooding	brooding
bestow	bestoww,bestow
footage	footage
threefold	threefold
weddings	weddings
outlaw	outlaww,outlaw
horsepower	horsepowwer,horsepower
gee	geee,gee
preexisting	preexisting
bowing	bowwing,bowing
beet	beeet,beet
unforeseen	unforeseen
zoology	zoology
snowy	snowy
reeds	reeeds,reeds
loosened	looosened,loosened
malawi	malawwi,malawi
spawning	spawning
howling	howwling,howling
zool	zool
squeezing	squeezing
cowboys	cowwboys,cowboys
granddaughter	granddaughter
endowments	endowments
eileen	eileeen,eileen
marlowe	marlowwe,marlowe
balloons	ballooons,balloons
sherwood	sherwood
downing	dowwning,downing
ddt	ddt
budding	buddding,budding
lowly	lowwly,lowly
shuddered	shuddered
burrows	burrowws,burrows
poole	pooole,poole
meek	meeek,meek
blooms	blooms
fleets	fleets
hardwood	hardwood
oversee	oversee
booming	boooming,booming
teaspoons	teaspooons,teaspoons
awaits	awaits
paw	paww,paw
greenish	greenish
troubleshooting	troubleshoooting,troubleshooting
nominee	nomineee,nominee
loomed	looomed,loomed
claw	claw
awfully	awfully
guaranteeing	guaranteeeing,guaranteeing
sweeps	sweeps
overthrown	overthrown
schooner	schooner
empowering	empowering
blooded	blooded
cameroon	camerooon,cameroon
addict	addict
strawberries	strawberries
embedding	embedding
booked	boooked,booked
creeks	creeks
beecher	beeecher,beecher
avowed	avowed
maureen	maureeen,maureen
overshadowed	overshadowed
reeves	reeeves,reeves
shudder	shudder
townships	towwnships,townships
padded	paddded,padded
gallbladder	gallbladdder,gallbladder
coolidge	cooolidge,coolidge
rowland	rowwland,rowland
overflowing	overflowing
lawns	lawwns,lawns
steered	steered
dawned	dawwned,dawned
beers	beeers,beers
downright	dowwnright,downright
deepen	deeepen,deepen
barefoot	barefooot,barefoot
bidder	biddder,bidder
eyebrow	eyebroww,eyebrow
hometown	hometowwn,hometown
shawl	shawl
trainee	traineee,trainee
toddler	todddler,toddler
middlesex	midddlesex,middlesex
rees	reees,rees
yellowstone	yellowwstone,yellowstone
foothills	foothills
scoop	scoop
freezer	freezer
gunpowder	gunpowwder,gunpowder
veneer	veneeer,veneer
slows	slows
blooming	blooming
peacekeeping	peacekeeeping,peacekeeping
breeders	breeders
bowers	bowwers,bowers
bower	bowwer,bower
fallow	fallow
empower	empower
taboos	tabooos,taboos
crows	crows
pedigree	pedigreee,pedigree
steeply	steeply
keel	keeel,keel
cowardice	cowwardice,cowardice
canaan	canaaan,canaan
bloodstream	bloodstream
sprawling	sprawling
statehood	statehood
bowels	bowwels,bowels
frowning	frowning
voor	vooor,voor
outgrowth	outgrowwth,outgrowth
fellowships	fellowships
haas	haaas,haas
browsing	browsing
grooming	grooming
glowed	glowed
thaw	thaww,thaw
goddard	godddard,goddard
breastfeeding	breastfeeding
cowardly	cowwardly,cowardly
inflows	inflows
reindeer	reindeeer,reindeer
spawned	spawned
seer	seeer,seer
eerie	eeerie,eerie
bellows	bellowws,bellows
footwear	footwear
schoolmaster	schoolmaster
fiddle	fiddle
howells	howwells,howells
goddamn	godddamn,goddamn
musee	museee,musee
screenplay	screenplay
mcdowell	mcdowell
rudder	ruddder,rudder
lawfully	lawwfully,lawfully
ballroom	ballrooom,ballroom
footprints	footprints
devotee	devoteee,devotee
freedmen	freedmen
referee	refereee,referee
woo	woo
overcrowded	overcrowded
bazaar	bazaaar,bazaar
fooled	fooled
brownish	brownish
woodlands	woodlands
horowitz	horowwitz,horowitz
chow	choww,chow
sunflower	sunflowwer,sunflower
interviewees	interviewees
harlow	harloww,harlow
browsers	browsers
woollen	woollen
flowered	flowered
freeway	freeway
hoop	hooop,hoop
awkwardly	awkwardly
gowns	gowwns,gowns
loosening	looosening,loosening
steeped	steeped
reese	reeese,reese
sweetly	sweetly
freddie	freddie
breeder	breeder
jawaharlal	jawaharlal
deems	deeems,deems
reelection	reeelection,reelection
powerpoint	powwerpoint,powerpoint
sleek	sleek
booking	boooking,booking
powerlessness	powwerlessness,powerlessness
stowe	stowe
borrowings	borrowwings,borrowings
soot	sooot,soot
peeling	peeeling,peeling
looming	loooming,looming
seedling	seeedling,seedling
eel	eeel,eel
howl	howwl,howl
freelance	freelance
lawless	lawwless,lawless
footed	footed
booty	boooty,booty
rowan	rowwan,rowan
workflow	workflow
creeds	creeds
peep	peeep,peep
lucknow	lucknoww,lucknow
troopers	trooopers,troopers
redeemer	redeeemer,redeemer
booster	boooster,booster
greeley	greeley
overgrown	overgrown
withdrawals	withdrawals
moons	mooons,moons
maslow	masloww,maslow
coolness	cooolness,coolness
toddlers	todddlers,toddlers
foothold	foothold
seeded	seeeded,seeded
bowles	bowwles,bowles
doorstep	dooorstep,doorstep
paws	pawws,paws
wheeling	wheeling
roofing	rooofing,roofing
rowing	rowwing,rowing
kneel	kneel
overseer	overseer
hooper	hoooper,hooper
studded	studded
foresaw	foresaw
crowning	crowning
ladders	laddders,ladders
townspeople	towwnspeople,townspeople
outlawed	outlawwed,outlawed
renown	renowwn,renown
stooped	stooped
genteel	genteeel,genteel
breeches	breeches
bookkeeping	boookkeeeping,bookkeeping
peek	peeek,peek
burrow	burroww,burrow
chimpanzees	chimpanzeees,chimpanzees
tweed	tweed
addictive	addictive
seeding	seeeding,seeding
owls	owls
redwood	redwood
absenteeism	absenteeism
underwood	underwood
shredded	shredded
bathrooms	bathroooms,bathrooms
coolly	cooolly,coolly
soothe	sooothe,soothe
greenfield	greenfield
zoological	zoological
wellknown	wellknown
swallows	swallows
bibliobazaar	bibliobazaaar,bibliobazaar
bungalow	bungaloww,bungalow
judd	judd
overpowering	overpowering
reddy	redddy,reddy
foolishness	foolishness
shopkeepers	shopkeepers
adduced	adduced
cowan	cowwan,cowan
cooperated	coooperated,cooperated
booker	boooker,booker
google	gooogle,google
spoons	spoons
hee	heee,hee
booths	boooths,booths
stoop	stoop
winslow	winslow
noodles	nooodles,noodles
shadowed	shadowed
feeders	feeders
wedded	wedded
woolen	woolen
awarding	awarding
speechless	speechless
handbooks	handboooks,handbooks
homeowners	homeowwners,homeowners
unknowns	unknowns
coolant	cooolant,coolant
narrows	narrowws,narrows
overcrowding	overcrowding
lowry	lowwry,lowry
steeper	steeper
gower	gowwer,gower
knowles	knowles
okinawa	okinawa
roommate	rooommate,roommate
rooting	roooting,rooting
seaweed	seawweed,seaweed
greer	greer
foote	foote
gallows	gallowws,gallows
looting	loooting,looting
superpower	superpowwer,superpower
trusteeship	trusteeeship,trusteeship
glee	glee
showered	showered
flooring	flooring
buddies	budddies,buddies
discreetly	discreeetly,discreetly
willows	willows
salaam	salaaam,salaam
absentee	absentee
overlooks	overlooks
sheen	sheen
superpowers	superpowwers,superpowers
addis	addis
addressee	addressee
mcgee	mcgee
pow	poww,pow
loo	looo,loo
redeeming	redeeeming,redeeming
faa	faa
longfellow	longfelloww,longfellow
smoother	smoother
cowley	cowwley,cowley
loot	looot,loot
drooping	drooping
tokugawa	tokugawwa,tokugawa
schoolboy	schoolboy
poona	pooona,poona
padding	paddding,padding
browns	browns
slowness	slowness
furrow	furrow
mellow	melloww,mellow
drowsiness	drowsiness
canteen	canteeen,canteen
holloway	hollowway,holloway
grower	grower
cooley	coooley,cooley
sorrowful	sorrowwful,sorrowful
chinatown	chinatowwn,chinatown
sarawak	sarawwak,sarawak
scooped	scooped
bowie	bowwie,bowie
nominees	nomineees,nominees
boo	booo,boo
doorways	dooorways,doorways
moot	mooot,moot
interviewee	interviewee
galloway	gallowway,galloway
crowley	crowley
transferee	transfereee,transferee
pawn	pawwn,pawn
frees	frees
sweeney	sweeney
baal	baaal,baal
breakdowns	breakdowns
haworth	hawworth,haworth
plowing	plowing
downloaded	dowwnloaded,downloaded
roofed	rooofed,roofed
kangaroo	kangarooo,kangaroo
tattoo	tattooo,tattoo
worksheets	worksheets
riddles	ridddles,riddles
smoothness	smoothness
bylaws	bylawws,bylaws
outlaws	outlawws,outlaws
mohawk	mohawwk,mohawk
fawcett	fawcett
ow	ow
uprooted	uprooted
sprawled	sprawled
bookseller	boookseller,bookseller
weeding	weeding
mooney	moooney,mooney
biofeedback	biofeeedback,biofeedback
hooves	hoooves,hooves
giddens	giddens
carefree	carefreee,carefree
lockwood	lockwood
renee	reneee,renee
halloween	hallowween,halloween
borrows	borrowws,borrows
buddhas	budddhas,buddhas
shutdown	shutdown
bradshaw	bradshaw
chimpanzee	chimpanzeee,chimpanzee
towed	towwed,towed
airflow	airfloww,airflow
mortgagee	mortgageee,mortgagee
hoof	hooof,hoof
lockheed	lockheeed,lockheed
reestablish	reeestablish,reestablish
schoolchildren	schoolchildren
oocytes	ooocytes,oocytes
dundee	dundeee,dundee
teeming	teeeming,teeming
bedded	beddded,bedded
escrow	escrow
fleece	fleece
moorish	mooorish,moorish
flowchart	flowchart
beets	beeets,beets
middlemen	midddlemen,middlemen
booksellers	boooksellers,booksellers
hallowed	hallowwed,hallowed
waterproof	waterproof
snows	snows
nawab	nawwab,nawab
spawn	spawn
sleepless	sleepless
lawmakers	lawwmakers,lawmakers
chattanooga	chattanoooga,chattanooga
norwood	norwood
plowed	plowed
withdraws	withdraws
toothed	tooothed,toothed
growths	growths
cheeses	cheeeses,cheeses
rupee	rupeee,rupee
bloomfield	bloomfield
breech	breech
selfhood	selfhoood,selfhood
toolbox	tooolbox,toolbox
sleeper	sleeper
rooster	roooster,rooster
saddled	sadddled,saddled
boosted	booosted,boosted
onlookers	onlookers
bookstores	boookstores,bookstores
tween	tween
leech	leeech,leech
maastricht	maaastricht,maastricht
eeoc	eeeoc,eeoc
breezes	breezes
blackwood	blackwood
assignee	assignee
sweetest	sweetest
seaward	seawward,seaward
appointees	appointees
foolishly	foolishly
lees	leees,lees
booklets	boooklets,booklets
ruddy	rudddy,ruddy
needful	neeedful,needful
toynbee	toynbeee,toynbee
pee	peee,pee
nationhood	nationhoood,nationhood
hollows	hollowws,hollows
schoolhouse	schoolhouse
overtook	overtook
woodstock	woodstock
faraway	faraway
upkeep	upkeep
seepage	seeepage,seepage
volunteering	volunteeering,volunteering
sparrows	sparrows
overseeing	overseeing
reeling	reeeling,reeling
freddy	freddy
cuckoo	cuckooo,cuckoo
whirlpool	whirlpool
overseers	overseers
reels	reeels,reels
showcase	showcase
doorbell	dooorbell,doorbell
lawton	lawwton,lawton
nineteenthcentury	nineteeenthcentury,nineteenthcentury
osgood	osgood
oocyte	ooocyte,oocyte
shooter	shooter
crowell	crowell
dawes	dawwes,dawes
madden	maddden,madden
foreshadowed	foreshadowed
goodrich	gooodrich,goodrich
coop	cooop,coop
guidebook	guideboook,guidebook
rowed	rowwed,rowed
seething	seeething,seething
awed	awed
rowley	rowwley,rowley
lookup	loookup,lookup
goodly	gooodly,goodly
zooplankton	zooplankton
jamestown	jamestown
trooper	troooper,trooper
sawdust	sawwdust,sawdust
cracow	cracow
hooded	hoooded,hooded
groomed	groomed
goodnight	gooodnight,goodnight
cree	cree
rangoon	rangooon,rangoon
yawning	yawwning,yawning
needham	neeedham,needham
steers	steers
attlee	attlee
woodwork	woodwork
biddle	bidddle,biddle
fatherhood	fatherhood
saws	sawws,saws
widower	widower
lawlessness	lawwlessness,lawlessness
cherokees	cherokeees,cherokees
retirees	retireees,retirees
sightseeing	sightseeeing,sightseeing
woodruff	woodruff
harrow	harroww,harrow
hodder	hoddder,hodder
riddled	ridddled,riddled
schoolteacher	schoolteacher
kidd	kiddd,kidd
sweeter	sweeter
bellow	belloww,bellow
freezes	freezes
sloop	sloop
fawn	fawn
cowper	cowwper,cowper
floodplain	floodplain
boosting	booosting,boosting
towing	towwing,towing
reeve	reeeve,reeve
streetcar	streetcar
sprawl	sprawl
drowsy	drowsy
payee	payeee,payee
furrows	furrows
hawley	hawwley,hawley
saddles	sadddles,saddles
geertz	geeertz,geertz
cools	coools,cools
bidders	biddders,bidders
scarecrow	scarecrow
steed	steed
puddle	pudddle,puddle
personhood	personhoood,personhood
soothed	sooothed,soothed
downside	dowwnside,downside
dawning	dawwning,dawning
preeminent	preeminent
undergrowth	undergrowth
giddy	giddy
cocoon	cocooon,cocoon
howled	howwled,howled
isaacs	isaacs
freemen	freemen
growl	growl
pyrenees	pyreneees,pyrenees
heeded	heeeded,heeded
schooled	schooled
harrowing	harrowwing,harrowing
booze	boooze,booze
sneer	sneer
sawmill	sawwmill,sawmill
longstreet	longstreeet,longstreet
beowulf	beowwulf,beowulf
ree	reee,ree
slowdown	slowdown
cheerfulness	cheeerfulness,cheerfulness
redrawn	redrawwn,redrawn
adder	adder
hooke	hoooke,hooke
eddies	eddies
malinowski	malinowwski,malinowski
clowns	clowns
preschoolers	preschoolers
eels	eeels,eels
saddened	sadddened,saddened
boomed	booomed,boomed
disallowed	disallowwed,disallowed
bookshop	boookshop,bookshop
middletown	midddletowwn,middletown
crowe	crowe
waterfowl	waterfowl
downturn	dowwnturn,downturn
ludlow	ludloww,ludlow
eerdmans	eeerdmans,eerdmans
sundown	sundowwn,sundown
dragoons	dragoons
fiancee	fiancee
cauliflower	cauliflowwer,cauliflower
freehold	freehold
atwood	atwood
moored	mooored,moored
shampoo	shampoo
speeded	speeded
spool	spool
looted	loooted,looted
flawless	flawless
greenville	greenville
cookery	coookery,cookery
unknowable	unknowable
yawned	yawwned,yawned
untoward	untoward
heywood	heywood
mckee	mckee
maroon	marooon,maroon
afrikaans	afrikaans
endow	endow
gnawing	gnawing
cladding	cladding
detainees	detaineees,detainees
weekdays	weekdays
budd	buddd,budd
scowled	scowled
addams	addams
lagoons	lagooons,lagoons
bellowed	bellowwed,bellowed
footprint	footprint
fooling	fooling
coo	cooo,coo
leeward	leeeward,leeward
imbedded	imbedded
footer	footer
waals	waals
coon	cooon,coon
dowager	dowwager,dowager
neighbourhoods	neighbourhooods,neighbourhoods
tooling	toooling,tooling
knower	knower
awkwardness	awkwardness
seers	seeers,seers
awakens	awakens
woolly	woolly
boomers	booomers,boomers
prodded	prodded
cookbook	coookboook,cookbook
loomis	looomis,loomis
ladd	laddd,ladd
inbreeding	inbreeding
scrapbook	scrapbook
ncaa	ncaa
reestablished	reeestablished,reestablished
afoot	afoot
levee	leveee,levee
saloons	salooons,saloons
collingwood	collingwood
browned	browned
grantee	grantee
trodden	troddden,trodden
narrowness	narrowwness,narrowness
blower	blower
fowls	fowls
reentry	reeentry,reentry
sneered	sneered
toothpaste	tooothpaste,toothpaste
lowercase	lowwercase,lowercase
whooping	whooping
downloading	dowwnloading,downloading
downsizing	dowwnsizing,downsizing
muddled	mudddled,muddled
gazetteer	gazetteeer,gazetteer
looped	loooped,looped
disagrees	disagreees,disagrees
shawn	shawn
foodgrains	foodgrains
overpowered	overpowered
shopkeeper	shopkeeper
booms	boooms,booms
dower	dowwer,dower
homewood	homewood
misdeeds	misdeeeds,misdeeds
goode	gooode,goode
meddling	medddling,meddling
roost	rooost,roost
needlessly	neeedlessly,needlessly
lows	lowws,lows
leeway	leeeway,leeway
creeps	creeps
withstood	withstood
donee	doneee,donee
innkeeper	innkeeper
muddle	mudddle,muddle
hawthorn	hawwthorn,hawthorn
puree	pureee,puree
hoops	hooops,hoops
thawing	thawwing,thawing
noose	nooose,noose
addendum	addendum
mee	meee,mee
feedings	feedings
wheezing	wheezing
mowing	mowwing,mowing
cooperatively	coooperatively,cooperatively
pows	powws,pows
yorktown	yorktowwn,yorktown
bigelow	bigeloww,bigelow
sourcebook	sourceboook,sourcebook
preemptive	preemptive
cottonwood	cottonwood
coordinators	cooordinators,coordinators
beseech	beseeech,beseech
widowhood	widowhood
sawing	sawwing,sawing
heeled	heeeled,heeled
hawkes	hawwkes,hawkes
stowed	stowed
nook	noook,nook
grooved	grooved
showdown	showdown
haw	haww,haw
voodoo	vooodooo,voodoo
colleen	colleeen,colleen
marlow	marloww,marlow
tuskegee	tuskegeee,tuskegee
arrowheads	arrowheads
mooring	moooring,mooring
uaw	uaww,uaw
arrowhead	arrowhead
outflows	outflowws,outflows
shuddering	shuddering
crooks	crooks
showy	showy
hoofs	hooofs,hoofs
mow	moww,mow
nightgown	nightgowwn,nightgown
feebly	feebly
preemption	preemption
stoddard	stoddard
goodyear	gooodyear,goodyear
gawain	gawwain,gawain
stow	stow
hollowed	hollowwed,hollowed
uptown	uptown
goody	gooody,goody
downed	dowwned,downed
steeple	steeple
barrows	barrowws,barrows
looping	loooping,looping
sheehan	sheehan
spreadsheets	spreadsheets
middleclass	midddleclass,middleclass
geddes	gedddes,geddes
hoods	hooods,hoods
flowery	flowery
mower	mowwer,mower
harwood	harwood
reddened	redddened,reddened
bloodless	bloodless
mukherjee	mukherjeee,mukherjee
rookie	roookie,rookie
weekday	weekday
keene	keeene,keene
tawny	tawwny,tawny
haywood	haywood
homeowner	homeowwner,homeowner
sleepers	sleepers
sisterhood	sisterhoood,sisterhood
addictions	addictions
townshend	towwnshend,townshend
gaap	gaaap,gaap
speer	speer
unseemly	unseemly
hawking	hawwking,hawking
greensboro	greensboro
unknowingly	unknowingly
tallow	talloww,tallow
jigsaw	jigsaw
shallower	shallower
cheery	cheeery,cheery
awry	awry
livelihoods	livelihooods,livelihoods
toolkit	tooolkit,toolkit
chatterjee	chatterjeee,chatterjee
franchisee	franchisee
loopholes	looopholes,loopholes
yawn	yawwn,yawn
domineering	domineeering,domineering
looser	loooser,looser
ddr	ddr
thawed	thawwed,thawed
bowler	bowwler,bowler
licensees	licenseees,licensees
burrowing	burrowwing,burrowing
veered	veeered,veered
bootstrap	boootstrap,bootstrap
sweetened	sweetened
underfoot	underfoot
darrow	darroww,darrow
woodcock	woodcock
paddling	padddling,paddling
reelected	reeelected,reelected
headdress	headddress,headdress
firepower	firepower
cowards	cowwards,cowards
meekly	meeekly,meekly
berkowitz	berkowwitz,berkowitz
brooch	brooch
empowers	empowers
aas	aaas,aas
maddox	madddox,maddox
woodcut	woodcut
shadowing	shadowing
lansdowne	lansdowwne,lansdowne
threedimensional	threedimensional
kilowatt	kilowwatt,kilowatt
peerage	peeerage,peerage
wedgwood	wedgwood
choctaw	choctaww,choctaw
soo	sooo,soo
stooping	stooping
followup	followup
greenery	greenery
croom	croom
touchdown	touchdowwn,touchdown
unlawfully	unlawfully
coombs	cooombs,coombs
pooh	poooh,pooh
rowdy	rowwdy,rowdy
baboons	babooons,baboons
offshoot	offshoot
hardwoods	hardwoods
preeminence	preeminence
agreeably	agreeably
bowlby	bowwlby,bowlby
prodding	prodding
bookcase	boookcase,bookcase
klee	klee
meer	meeer,meer
bookkeeper	boookkeeeper,bookkeeper
toothbrush	tooothbrush,toothbrush
paddock	padddock,paddock
cheddar	chedddar,cheddar
bowden	bowwden,bowden
knowable	knowable
aan	aaan,aan
warszawa	warszawa
tallahassee	tallahasseee,tallahassee
growling	growling
bloomsbury	bloomsbury
freemasonry	freemasonry
reexamination	reeexamination,reexamination
paddles	padddles,paddles
towered	towwered,towered
heen	heeen,heen
cheekbones	cheeekbones,cheekbones
hawke	hawwke,hawke
knighthood	knighthood
narrowest	narrowwest,narrowest
entree	entree
outgrown	outgrowwn,outgrown
shawnee	shawnee
loon	looon,loon
peeping	peeeping,peeping
bestows	bestowws,bestows
hathaway	hathawway,hathaway
linseed	linseeed,linseed
adductor	adductor
dowling	dowwling,dowling
furrowed	furrowed
straws	straws
coolies	cooolies,coolies
woodpecker	woodpecker
banerjee	banerjeee,banerjee
peeked	peeeked,peeked
mayflower	mayflowwer,mayflower
mistook	mistoook,mistook
rhee	rhee
baboon	babooon,baboon
slowest	slowest
oozing	ooozing,oozing
proofreading	proofreading
canaanite	canaaanite,canaanite
peshawar	peshawwar,peshawar
greets	greets
middling	midddling,middling
sows	sowws,sows
wooing	wooing
spree	spree
inlaw	inlaw
unacknowledged	unacknowledged
kalamazoo	kalamazooo,kalamazoo
huddle	hudddle,huddle
dawkins	dawwkins,dawkins
powdery	powwdery,powdery
aachen	aaachen,aachen
appellee	appellee
auctioneer	auctioneeer,auctioneer
loosed	looosed,loosed
wildflowers	wildflowers
hoo	hooo,hoo
kee	keee,kee
rowman	rowwman,rowman
overflowed	overflowed
rostow	rostoww,rostow
needlework	neeedlework,needlework
footman	footman
snowfall	snowfall
screeching	screeching
tattooed	tattoooed,tattooed
scowl	scowl
moonlit	mooonlit,moonlit
overridden	overridden
sawed	sawwed,sawed
yellows	yellowws,yellows
seep	seeep,seep
deepens	deeepens,deepens
fiddler	fiddler
bestowing	bestowwing,bestowing
cooker	coooker,cooker
schoolroom	schoolroom
noaa	noaaa,noaa
meddle	medddle,meddle
sowie	sowwie,sowie
towne	towwne,towne
liddell	lidddell,liddell
toolbars	tooolbars,toolbars
shipowners	shipowners
reeled	reeeled,reeled
shallows	shallows
woodworking	woodworking
cooh	coooh,cooh
knowledges	knowledges
greenspan	greenspan
raccoon	raccooon,raccoon
snowball	snowball
referees	refereees,referees
clawed	clawed
downcast	dowwncast,downcast
sodden	soddden,sodden
middleman	midddleman,middleman
reevaluation	reeevaluation,reevaluation
brownian	brownian
downey	dowwney,downey
tattoos	tattooos,tattoos
puddles	pudddles,puddles
microorganism	microoorganism,microorganism
lookin	loookin,lookin
screech	screech
reengineering	reeengineeering,reengineering
shipowner	shipowner
groot	groot
moorings	mooorings,moorings
brownsville	brownsville
doo	dooo,doo
squaw	squaw
keenan	keeenan,keenan
woodbury	woodbury
doolittle	dooolittle,doolittle
holbrook	holbroook,holbrook
rooney	roooney,rooney
attendees	attendees
typhoon	typhooon,typhoon
uncooperative	uncooperative
flees	flees
overgrowth	overgrowth
storeroom	storeroom
dooley	doooley,dooley
suddenness	sudddenness,suddenness
braddock	braddock
swoop	swoop
veer	veeer,veer
keener	keeener,keener
heedless	heeedless,heedless
straddle	straddle
townsmen	towwnsmen,townsmen
runaways	runawways,runaways
magee	mageee,magee
apogee	apogee
rooftop	roooftop,rooftop
moo	mooo,moo
privateers	privateers
downy	dowwny,downy
ghee	gheee,ghee
goodies	gooodies,goodies
gleefully	gleefully
flywheel	flywheel
sheeting	sheeting
zoos	zoos
eighteenthcentury	eighteeenthcentury,eighteenthcentury
bookmark	boookmark,bookmark
oddity	oddity
prow	prow
sneezing	sneezing
shootings	shootings
caa	caaa,caa
lightfoot	lightfooot,lightfoot
bool	boool,bool
brookes	brookes
woodbridge	woodbridge
swooped	swooped
patentee	patenteee,patentee
paddled	padddled,paddled
freestanding	freestanding
dowel	dowwel,dowel
maw	maww,maw
mountaineers	mountaineeers,mountaineers
selfesteem	selfesteeem,selfesteem
lawler	lawwler,lawler
billowing	billowwing,billowing
zee	zee
idee	idee
scrawled	scrawled
beaverbrook	beaverbroook,beaverbrook
reexamine	reeexamine,reexamine
gatekeeper	gatekeeeper,gatekeeper
hawaiians	hawwaiians,hawaiians
woodhouse	woodhouse
downwind	dowwnwind,downwind
subcommittees	subcommitteees,subcommittees
charlestown	charlestowwn,charlestown
beep	beeep,beep
peddlers	pedddlers,peddlers
unawares	unawares
bradstreet	bradstreet
foolhardy	foolhardy
marquee	marqueee,marquee
bungalows	bungalowws,bungalows
casebook	caseboook,casebook
sweetie	sweetie
maddening	madddening,maddening
eastwood	eastwood
saar	saaar,saar
bluetooth	bluetooth
outlooks	outloooks,outlooks
iaa	iaaa,iaa
seeped	seeeped,seeped
bloodthirsty	bloodthirsty
aloofness	aloofness
sowed	sowwed,sowed
brawl	brawl
breen	breen
chinook	chinoook,chinook
toothache	tooothache,toothache
thaddeus	thadddeus,thaddeus
pawnee	pawwneee,pawnee
rood	roood,rood
footpath	footpath
kuwaiti	kuwwaiti,kuwaiti
doorman	dooorman,doorman
overthrowing	overthrowing
evergreens	evergreens
loophole	looophole,loophole
schoolwork	schoolwork
shoddy	shoddy
greener	greener
glows	glows
adduction	adduction
waddell	waddell
queene	queeene,queene
shawls	shawls
ooze	oooze,ooze
sawn	sawwn,sawn
downtrodden	dowwntroddden,downtrodden
greenpeace	greenpeace
downpour	dowwnpour,downpour
threes	threes
sleeved	sleeved
snowstorm	snowstorm
dodds	doddds,dodds
greenhouses	greenhouses
bloomed	bloomed
peddler	pedddler,peddler
woodcuts	woodcuts
awash	awash
mcgowan	mcgowan
brookfield	brookfield
doreen	doreeen,doreen
rook	roook,rook
oversaw	oversaw
krakow	krakow
owne	owne
armageddon	armageddon
grooms	grooms
bowker	bowwker,bowker
gloomily	gloomily
midden	middden,midden
plows	plows
willpower	willpower
howie	howwie,howie
goddamned	godddamned,goddamned
greedily	greedily
preempted	preempted
oversees	oversees
hobsbawm	hobsbawwm,hobsbawm
pawns	pawwns,pawns
mcgrawhill	mcgrawhill
overflows	overflows
straddling	straddling
foreshadowing	foreshadowing
weevil	weevil
rosewood	rosewood
cee	ceee,cee
boosters	booosters,boosters
deere	deeere,deere
kawasaki	kawwasaki,kawasaki
sleet	sleet
downtime	dowwntime,downtime
crawley	crawley
chee	cheee,chee
brownell	brownell
rooftops	roooftops,rooftops
yee	yeee,yee
spoonful	spoonful
cartoonist	cartooonist,cartoonist
bittersweet	bittersweet
booby	boooby,booby
seeping	seeeping,seeping
showroom	showroom
broods	broods
saddest	sadddest,saddest
uncoordinated	uncoordinated
overshoot	overshoot
beehive	beeehive,beehive
workbooks	workbooks
plodding	plodding
naa	naaa,naa
droop	droop
yaw	yaww,yaw
woolley	woolley
rudd	ruddd,rudd
rainbows	rainbowws,rainbows
roos	rooos,roos
disagreeing	disagreeeing,disagreeing
howls	howwls,howls
pocketbook	pocketboook,pocketbook
addie	addie
reproof	reprooof,reproof
driftwood	driftwood
meekness	meeekness,meekness
scowling	scowling
gatekeepers	gatekeeepers,gatekeepers
freehand	freehand
yarrow	yarroww,yarrow
crowther	crowther
redding	reddding,redding
loos	looos,loos
middleware	midddleware,middleware
prowling	prowling
drawled	drawled
westwood	westwood
steely	steely
harpoon	harpooon,harpoon
mawr	mawwr,mawr
foreknowledge	foreknowledge
unheeded	unheeded
weeps	weeps
fiddling	fiddling
forenoon	forenoon
prawns	prawns
girlhood	girlhood
goodall	gooodall,goodall
kiowa	kiowwa,kiowa
woodman	woodman
agee	agee
platoons	platoons
sleepiness	sleepiness
sneeze	sneeze
newsroom	newsrooom,newsroom
appointee	appointee
scooter	scooter
overshadow	overshadow
brownie	brownie
brooded	brooded
wheelchairs	wheelchairs
darkroom	darkrooom,darkroom
levees	leveees,levees
microwaves	microwwaves,microwaves
goodenough	gooodenough,goodenough
bawdy	bawwdy,bawdy
footings	footings
melee	meleee,melee
blackfoot	blackfoot
woodson	woodson
uw	uw
bookshelves	boookshelves,bookshelves
greening	greening
powerhouse	powwerhouse,powerhouse
seeger	seeeger,seeger
bookmarks	boookmarks,bookmarks
coolie	cooolie,coolie
steelworkers	steelworkers
falsehoods	falsehoods
storekeeper	storekeeper
getaway	getawway,getaway
waa	waa
bellowing	bellowwing,bellowing
freetown	freetown
maas	maaas,maas
maccabees	maccabeees,maccabees
poodle	pooodle,poodle
vee	veee,vee
lawmaking	lawwmaking,lawmaking
booted	boooted,booted
jeeps	jeeps
haarlem	haaarlem,haarlem
naw	naww,naw
hoot	hooot,hoot
midtown	midtowwn,midtown
rundown	rundowwn,rundown
gnawed	gnawed
indiscreet	indiscreet
leeches	leeeches,leeches
freeport	freeport
greenleaf	greenleaf
hooking	hoooking,hooking
landowning	landowwning,landowning
backwoods	backwoods
kidder	kiddder,kidder
poop	pooop,poop
sandalwood	sandalwood
goo	gooo,goo
checkbook	checkboook,checkbook
sheepishly	sheepishly
rawlings	rawwlings,rawlings
drooped	drooped
kirkwood	kirkwood
awning	awning
peddling	pedddling,peddling
bloods	bloods
ioo	iooo,ioo
aimee	aimeee,aimee
noonday	nooonday,noonday
mcfadden	mcfadden
breezy	breezy
wheelbarrow	wheelbarrow
showering	showering
doorknob	dooorknob,doorknob
softwood	softwood
aladdin	aladdin
schoolboys	schoolboys
waddington	waddington
mountaineering	mountaineeering,mountaineering
rooming	roooming,rooming
sooty	soooty,sooty
vermeer	vermeeer,vermeer
snowden	snowden
boomer	booomer,boomer
airspeed	airspeeed,airspeed
roommates	rooommates,roommates
sallow	salloww,sallow
maddie	madddie,maddie
snowing	snowing
cowles	cowwles,cowles
creepy	creepy
bookshelf	boookshelf,bookshelf
paddington	padddington,paddington
entrees	entrees
consignee	consigneee,consignee
noodle	nooodle,noodle
paratroopers	paratrooopers,paratroopers
seedy	seeedy,seedy
tycoon	tycooon,tycoon
bassoon	bassooon,bassoon
tees	teees,tees
overpower	overpower
avowedly	avowedly
toothless	tooothless,toothless
reexamined	reeexamined,reexamined
steen	steen
foo	foo
greenblatt	greenblatt
totowa	totowwa,totowa
shooters	shooters
stanislaw	stanislaw
bowery	bowwery,bowery
foolproof	foolproof
hawes	hawwes,hawes
solow	soloww,solow
peeped	peeeped,peeped
mutineers	mutineeers,mutineers
leer	leeer,leer
unfeeling	unfeeling
hydropower	hydropowwer,hydropower
tomahawk	tomahawwk,tomahawk
pharisee	phariseee,pharisee
crackdown	crackdown
sulawesi	sulawwesi,sulawesi
snowflakes	snowflakes
staat	staat
toothpick	tooothpick,toothpick
keegan	keeegan,keegan
plowman	plowman
kraal	kraal
schoolgirl	schoolgirl
bowes	bowwes,bowes
bataan	bataaan,bataan
bailee	baileee,bailee
bookings	boookings,bookings
sassoon	sassooon,sassoon
rawlinson	rawwlinson,rawlinson
reevaluate	reeevaluate,reevaluate
oddities	oddities
maasai	maaasai,maasai
eddington	eddington
yellowing	yellowwing,yellowing
hawker	hawwker,hawker
baa	baaa,baa
cowed	cowwed,cowed
peeking	peeeking,peeking
saa	saaa,saa
screeched	screeched
spooner	spooner
disowned	disowwned,disowned
franchisees	franchisees
boomerang	booomerang,boomerang
doomsday	dooomsday,doomsday
uncooked	uncooked
cameroons	camerooons,cameroons
floored	floored
beebe	beeebe,beebe
downriver	dowwnriver,downriver
safekeeping	safekeeeping,safekeeping
schoolteachers	schoolteachers
ridding	riddding,ridding
preempt	preempt
keeler	keeeler,keeler
maddy	madddy,maddy
haddock	hadddock,haddock
lawgiver	lawwgiver,lawgiver
dogwood	dogwood
proofing	proofing
freeholders	freeholders
leeks	leeeks,leeks
noonan	nooonan,noonan
scrooge	scrooge
caddy	cadddy,caddy
uprooting	uprooting
guidebooks	guideboooks,guidebooks
skidded	skidded
broome	broome
peerless	peeerless,peerless
onlooker	onlooker
reece	reeece,reece
cottonseed	cottonseeed,cottonseed
leek	leeek,leek
tuscaloosa	tuscalooosa,tuscaloosa
spooky	spooky
downes	dowwnes,downes
schooners	schooners
yahoo	yahooo,yahoo
dawns	dawwns,dawns
haag	haaag,haag
frowns	frowns
regrowth	regrowwth,regrowth
restroom	restrooom,restroom
subtree	subtreee,subtree
looseness	loooseness,looseness
recordkeeping	recordkeeeping,recordkeeping
balaam	balaaam,balaam
coworker	cowworker,coworker
rawson	rawwson,rawson
billows	billowws,billows
floorboards	floorboards
ishikawa	ishikawa
reenter	reeenter,reenter
sawmills	sawwmills,sawmills
mowbray	mowwbray,mowbray
matinee	matineee,matinee
blowers	blowers
aiaa	aiaaa,aiaa
seeley	seeeley,seeley
kneels	kneels
zeeman	zeeman
cowell	cowwell,cowell
breakaway	breakaway
moorland	mooorland,moorland
isherwood	isherwood
weeklies	weeklies
rowell	rowwell,rowell
murrow	murroww,murrow
steepest	steepest
goddam	godddam,goddam
bleeds	bleeds
soweto	sowweto,soweto
bidden	biddden,bidden
bazaars	bazaaars,bazaars
redeemable	redeeemable,redeemable
doodle	dooodle,doodle
cocoons	cocooons,cocoons
wroclaw	wroclaw
dowd	dowwd,dowd
straightaway	straightaway
reestablishment	reeestablishment,reestablishment
schoolmasters	schoolmasters
roo	rooo,roo
windowless	windowless
newsreel	newsreeel,newsreel
disavowed	disavowwed,disavowed
examinee	examinee
feedstock	feedstock
internees	internees
saginaw	saginaww,saginaw
windowsill	windowsill
howland	howwland,howland
hedda	heddda,hedda
howes	howwes,howes
preeclampsia	preeclampsia
watertown	watertown
koo	kooo,koo
scrawny	scrawny
whoop	whoop
fuelwood	fuelwood
trawl	trawwl,trawl
enrollees	enrollees
albee	albee
creeper	creeper
brouwer	brouwer
handloom	handlooom,handloom
mcqueen	mcqueen
freemasons	freemasons
partook	partoook,partook
countdown	countdowwn,countdown
woodford	woodford
lawes	lawwes,lawes
darjeeling	darjeeeling,darjeeling
tattooing	tattoooing,tattooing
freeways	freeways
restrooms	restroooms,restrooms
giddings	giddings
sadder	saddder,sadder
outlawing	outlawwing,outlawing
bloodied	bloodied
rawhide	rawwhide,rawhide
witherspoon	witherspoon
feedforward	feedforward
steepness	steepness
lowenthal	lowwenthal,lowenthal
wooed	wooed
youngstown	youngstowwn,youngstown
jowett	jowett
unknowing	unknowing
brooms	brooms
drawdown	drawdown
bookshops	boookshops,bookshops
drawl	drawl
sneering	sneering
coopers	cooopers,coopers
reedy	reeedy,reedy
steeds	steeds
zooming	zooming
peels	peeels,peels
brower	brower
trowel	trowwel,trowel
downplay	dowwnplay,downplay
screenwriter	screenwriter
privateer	privateer
treetops	treeetops,treetops
saskatoon	saskatooon,saskatoon
snowed	snowed
mowed	mowwed,mowed
crawls	crawls
blackfeet	blackfeet
clawing	clawing
brotherhoods	brotherhoods
downloads	dowwnloads,downloads
sadducees	saddduceees,sadducees
beeswax	beeeswax,beeswax
tooke	toooke,tooke
lessees	lesseees,lessees
poore	pooore,poore
straddled	straddled
wheelwright	wheelwright
thrower	thrower
sheepskin	sheepskin
bedridden	bedriddden,bedridden
aad	aaad,aad
treeless	treeeless,treeless
keenest	keeenest,keenest
squeezes	squeezes
reddening	redddening,reddening
bloodshot	bloodshot
creel	creel
foreshadows	foreshadows
seaway	seawway,seaway
puddings	pudddings,puddings
canteens	canteeens,canteens
adduce	adduce
pedigrees	pedigreees,pedigrees
shee	shee
mooted	moooted,mooted
dde	dde
rowena	rowwena,rowena
endows	endows
roomy	rooomy,roomy
showman	showman
gooch	goooch,gooch
rabinowitz	rabinowwitz,rabinowitz
adducts	adducts
tawney	tawwney,tawney
coolers	cooolers,coolers
oilseeds	oilseeeds,oilseeds
powhatan	powwhatan,powhatan
offeree	offeree
knoweth	knoweth
cheeked	cheeeked,cheeked
sunflowers	sunflowwers,sunflowers
greenstone	greenstone
westbrook	westbrook
woolworth	woolworth
beecham	beeecham,beecham
footmen	footmen
wallow	wallow
fleetwood	fleetwood
germantown	germantowwn,germantown
mountaineer	mountaineeer,mountaineer
returnees	returneees,returnees
chickasaw	chickasaww,chickasaw
biweekly	biweekly
scudder	scudder
weedy	weedy
screenings	screenings
disavowal	disavowwal,disavowal
pontoon	pontooon,pontoon
rawlins	rawwlins,rawlins
rowntree	rowwntreee,rowntree
moonshine	mooonshine,moonshine
settee	setteee,settee
sunscreen	sunscreeen,sunscreen
vendee	vendeee,vendee
neel	neeel,neel
seafloor	seaflooor,seafloor
adduct	adduct
sweeper	sweeper
lowenstein	lowwenstein,lowenstein
trawlers	trawwlers,trawlers
hetween	hetween
canaanites	canaaanites,canaanites
kowloon	kowwlooon,kowloon
crowing	crowing
grantees	grantees
quickbooks	quickboooks,quickbooks
kowalski	kowwalski,kowalski
swoon	swoon
maa	maaa,maa
brownies	brownies
paa	paaa,paa
zoologist	zoologist
bristow	bristow
udder	udder
sweeteners	sweeteners
uproot	uproot
nauvoo	nauvooo,nauvoo
kilowatts	kilowwatts,kilowatts
boogie	booogie,boogie
yellowed	yellowwed,yellowed
elwood	elwood
prowl	prowl
wallowing	wallowing
conferees	confereees,conferees
meerut	meeerut,meerut
foreseeing	foreseeing
townsfolk	towwnsfolk,townsfolk
rickshaw	rickshaww,rickshaw
nowak	nowwak,nowak
kangaroos	kangarooos,kangaroos
strawson	strawson
sauteed	sauteeed,sauteed
tweezers	tweezers
madder	maddder,madder
ogawa	ogawa
haddon	hadddon,haddon
jeered	jeered
musketeers	musketeeers,musketeers
kershaw	kershaww,kershaw
haddad	hadddad,haddad
neely	neeely,neely
yearbooks	yearboooks,yearbooks
eerily	eeerily,eerily
schoolmates	schoolmates
offshoots	offshoots
wooster	wooster
proofread	proofread
howitzers	howwitzers,howitzers
callaway	callawway,callaway
knowest	knowest
deerfield	deeerfield,deerfield
embeddedness	embeddedness
bamboos	bambooos,bamboos
barefooted	barefoooted,barefooted
unfree	unfree
workweek	workweek
bookish	boookish,bookish
chowder	chowwder,chowder
brooches	brooches
greenwald	greenwald
dragoon	dragoon
moos	mooos,moos
zoomed	zoomed
disavow	disavoww,disavow
brookhaven	brookhaven
disallow	disalloww,disallow
boardroom	boardrooom,boardroom
appellees	appellees
cooney	coooney,cooney
crenshaw	crenshaw
maddened	madddened,maddened
heathrow	heathroww,heathrow
seeps	seeeps,seeps
mcadoo	mcadoo
aileen	aileeen,aileen
endowing	endowing
datasheet	datasheeet,datasheet
keenness	keeenness,keenness
avowal	avowal
crowder	crowder
knowlton	knowlton
eea	eeea,eea
enfeebled	enfeebled
profiteering	profiteering
knowed	knowed
woof	woof
addr	addr
woolwich	woolwich
sawtooth	sawwtoooth,sawtooth
sleeplessness	sleeplessness
outgrow	outgroww,outgrow
vallee	valleee,vallee
festooned	festooned
heeding	heeeding,heeding
bowdoin	bowwdoin,bowdoin
hartree	hartreee,hartree
poo	pooo,poo
pensee	penseee,pensee
widowers	widowers
retiree	retireee,retiree
commandeered	commandeeered,commandeered
heer	heeer,heer
provincetown	provincetown
sketchbook	sketchbook
sleepily	sleepily
genesee	geneseee,genesee
drawee	drawee
landownership	landowwnership,landownership
reestablishing	reeestablishing,reestablishing
foresees	foresees
scooping	scooping
onscreen	onscreen
cowen	cowwen,cowen
crabtree	crabtree
overseen	overseen
peachtree	peachtreee,peachtree
haraway	harawway,haraway
lowing	lowwing,lowing
swooping	swooping
hawkers	hawwkers,hawkers
charioteer	charioteeer,charioteer
aac	aaac,aac
awa	awa
creepers	creepers
cowering	cowwering,cowering
scoops	scoops
hedgerows	hedgerowws,hedgerows
yoo	yooo,yoo
peebles	peeebles,peebles
meeker	meeeker,meeker
addenda	addenda
boosts	booosts,boosts
downe	dowwne,downe
racketeering	racketeeering,racketeering
virchow	virchoww,virchow
riddell	ridddell,riddell
reenactment	reeenactment,reenactment
cooing	coooing,cooing
bookcases	boookcases,bookcases
cookbooks	coookboooks,cookbooks
raccoons	raccooons,raccoons
choo	chooo,choo
drooling	drooling
sweetener	sweetener
addington	addington
buddhahood	budddhahoood,buddhahood
unforeseeable	unforeseeable
forsook	forsook
haar	haaar,haar
crowed	crowed
disown	disowwn,disown
mudd	muddd,mudd
bawling	bawwling,bawling
electioneering	electioneering
minkowski	minkowwski,minkowski
hindoo	hindooo,hindoo
sweeten	sweeten
cowl	cowwl,cowl
cooperates	coooperates,cooperates
fddi	fddi
waal	waal
sheepish	sheepish
lifeblood	lifebloood,lifeblood
tawdry	tawwdry,tawdry
trowbridge	trowwbridge,trowbridge
morristown	morristowwn,morristown
paddies	padddies,paddies
prawn	prawn
oops	ooops,oops
armee	armee
woolsey	woolsey
bookman	boookman,bookman
beseeching	beseeeching,beseeching
cheesecake	cheeesecake,cheesecake
howarth	howwarth,howarth
goofy	gooofy,goofy
daw	daww,daw
brownlow	brownlow
awl	awl
bulawayo	bulawwayo,bulawayo
woodworth	woodworth
lawfulness	lawwfulness,lawfulness
soothingly	sooothingly,soothingly
naar	naaar,naar
brookline	brookline
filigree	filigree
sweethearts	sweethearts
oozed	ooozed,oozed
wormwood	wormwood
townhouse	towwnhouse,townhouse
evacuees	evacuees
nooks	noooks,nooks
skidding	skidding
hasegawa	hasegawwa,hasegawa
teething	teeething,teething
siddhartha	sidddhartha,siddhartha
speedup	speedup
heirloom	heirlooom,heirloom
iee	ieee,iee
trawler	trawwler,trawler
greenway	greenway
scheer	scheer
playroom	playroom
reeking	reeeking,reeking
seddon	sedddon,seddon
sheed	sheed
newtown	newtowwn,newtown
interbedded	interbedded
ddc	ddc
woodpeckers	woodpeckers
cheerleader	cheeerleader,cheerleader
cheetah	cheeetah,cheetah
bloodstained	bloodstained
neem	neeem,neem
loosing	looosing,loosing
buccaneers	buccaneeers,buccaneers
weeded	weeded
behooves	behoooves,behooves
veering	veeering,veering
minnow	minnoww,minnow
cheever	cheeever,cheever
downgraded	dowwngraded,downgraded
roddy	rodddy,roddy
whitelaw	whitelaw
mellowed	mellowwed,mellowed
snooping	snooping
bowled	bowwled,bowled
woodwind	woodwind
vowing	vowwing,vowing
downplayed	dowwnplayed,downplayed
wheelock	wheelock
hankow	hankoww,hankow
rootless	roootless,rootless
sweepstakes	sweepstakes
ooh	oooh,ooh
sleeveless	sleeveless
winnowing	winnowing
anteroom	anteroom
crossbow	crossbow
mohawks	mohawwks,mohawks
aglow	aglow
edd	edd
howitzer	howwitzer,howitzer
hookworm	hoookworm,hookworm
farrow	farrow
biddy	bidddy,biddy
aarhus	aaarhus,aarhus
redder	reddder,redder
streetcars	streetcars
maroons	marooons,maroons
sower	sowwer,sower
haan	haaan,haan
blackpool	blackpool
minnows	minnowws,minnows
downers	dowwners,downers
soong	sooong,soong
seaweeds	seawweeds,seaweeds
muldoon	muldooon,muldoon
motown	motowwn,motown
stoops	stoops
streeter	streeter
westlaw	westlaw
bree	bree
nowell	nowwell,nowell
reenacted	reeenacted,reenacted
foreshadow	foreshadow
steerage	steerage
workroom	workroom
footers	footers
markowitz	markowwitz,markowitz
drawbridge	drawbridge
windscreen	windscreen
biilow	biiloww,biilow
lowndes	lowwndes,lowndes
fireproof	fireproof
shallowness	shallowness
meehan	meeehan,meehan
sweepers	sweepers
keefe	keeefe,keefe
browder	browder
unsweetened	unsweetened
toddy	todddy,toddy
moskowitz	moskowwitz,moskowitz
plodded	plodded
snowflake	snowflake
mcphee	mcphee
downslope	dowwnslope,downslope
seventeenthcentury	seventeeenthcentury,seventeenthcentury
snowman	snowman
bladders	bladders
unbeknownst	unbeknownst
deadwood	deadwood
coolest	cooolest,coolest
unbidden	unbidden
reboot	rebooot,reboot
lowincome	lowwincome,lowincome
assessee	assessee
foodstuff	foodstuff
feelers	feelers
brownstone	brownstone
lowery	lowwery,lowery
additivity	additivity
wicklow	wicklow
floodplains	floodplains
meese	meeese,meese
thurgood	thurgoood,thurgood
hooted	hoooted,hooted
forefoot	forefoot
geer	geeer,geer
brownson	brownson
gnaw	gnaw
flowcharts	flowcharts
deepwater	deeepwater,deepwater
teaspoonful	teaspooonful,teaspoonful
buddhi	budddhi,buddhi
aarp	aaarp,aarp
baddeley	badddeley,baddeley
rooks	roooks,rooks
yazoo	yazooo,yazoo
jeering	jeering
redwoods	redwoods
scrapbooks	scrapbooks
rawalpindi	rawwalpindi,rawalpindi
footpaths	footpaths
reentered	reeentered,reentered
footstool	footstool
marooned	maroooned,marooned
kneeled	kneeled
agrawal	agrawal
showalter	showalter
spook	spook
gladden	gladden
desiree	desireee,desiree
greenstein	greenstein
fleetingly	fleetingly
washroom	washroom
powys	powwys,powys
callow	calloww,callow
springsteen	springsteen
scooted	scooted
calloway	callowway,calloway
ood	oood,ood
aaf	aaaf,aaf
grimshaw	grimshaw
examinees	examinees
bloomer	bloomer
redraw	redraww,redraw
adoptees	adoptees
toot	tooot,toot
ellwood	ellwood
hiawatha	hiawwatha,hiawatha
poughkeepsie	poughkeeepsie,poughkeepsie
sheehy	sheehy
repartee	reparteee,repartee
dds	dds
steelhead	steelhead
rowboat	rowwboat,rowboat
addressees	addressees
hallowell	hallowwell,hallowell
showings	showings
saad	saaad,saad
storybook	storybook
preeminently	preeminently
steeled	steeled
troubleshoot	troubleshooot,troubleshoot
throwback	throwback
ees	eees,ees
monsoons	monsooons,monsoons
cowling	cowwling,cowling
ook	oook,ook
smoot	smoot
cheerless	cheeerless,cheerless
homegrown	homegrowwn,homegrown
mushroomed	mushrooomed,mushroomed
brownlee	brownlee
meltdown	meltdowwn,meltdown
ozawa	ozawa
kooning	koooning,kooning
cartoonists	cartooonists,cartoonists
burrowed	burrowwed,burrowed
veneers	veneeers,veneers
disallowance	disallowwance,disallowance
footlights	footlights
heartwood	heartwood
deeming	deeeming,deeming
oop	ooop,oop
weddell	weddell
brushwood	brushwood
bloodletting	bloodletting
buffoon	buffooon,buffoon
innkeepers	innkeepers
rowlands	rowwlands,rowlands
ballooning	balloooning,ballooning
saarc	saaarc,saarc
highbrow	highbroww,highbrow
oeec	oeeec,oeec
oooo	oooooo,oooo
streamflow	streamflow
cuddled	cudddled,cuddled
sorrowfully	sorrowwfully,sorrowfully
housekeepers	housekeeepers,housekeepers
thurlow	thurloww,thurlow
cuddle	cudddle,cuddle
shoo	shoo
caraway	carawway,caraway
noor	nooor,noor
middleaged	midddleaged,middleaged
gow	goww,gow
showa	showa
lowther	lowwther,lowther
staats	staats
downlink	dowwnlink,downlink
threequarters	threequarters
cutaway	cutawway,cutaway
eez	eeez,eez
lycee	lyceee,lycee
booke	boooke,booke
glowered	glowered
weevils	weevils
tcdd	tcdd
shudders	shudders
delawares	delawwares,delawares
middlemarch	midddlemarch,middlemarch
cheerleaders	cheeerleaders,cheerleaders
detainee	detaineee,detainee
rowers	rowwers,rowers
vajpayee	vajpayeee,vajpayee
schoolmen	schoolmen
leed	leeed,leed
jeddah	jeddah
cowpea	cowwpea,cowpea
reek	reeek,reek
feebleness	feebleness
awami	awami
promisee	promisee
awakes	awakes
schoolyard	schoolyard
midafternoon	midafternooon,midafternoon
unneeded	unneeded
drowns	drowns
billow	billoww,billow
dowels	dowwels,dowels
afterglow	afterglow
dowries	dowwries,dowries
redeems	redeeems,redeems
dda	dda
aar	aaar,aar
mowers	mowwers,mowers
peevish	peeevish,peevish
grownups	grownups
mongoose	mongooose,mongoose
sowohl	sowwohl,sowohl
roosting	rooosting,roosting
woodside	woodside
toothpicks	tooothpicks,toothpicks
downgrading	dowwngrading,downgrading
seedbed	seeedbed,seedbed
hooting	hoooting,hooting
deeps	deeeps,deeps
speedometer	speedometer
safflower	safflowwer,safflower
newsreels	newsreeels,newsreels
pulpwood	pulpwood
laddie	ladddie,laddie
trapdoor	trapdooor,trapdoor
seesaw	seeesaww,seesaw
yaakov	yaaakov,yaakov
fawning	fawning
dartmoor	dartmooor,dartmoor
deportees	deporteees,deportees
preceeding	preceeding
snowshoes	snowshoes
legatee	legateee,legatee
coons	cooons,coons
chodorow	chodoroww,chodorow
edda	edda
fiddled	fiddled
hideaway	hideawway,hideaway
smallwood	smallwood
zeeland	zeeland
gaddis	gadddis,gaddis
waterproofing	waterproofing
spools	spools
lowermost	lowwermost,lowermost
mowrer	mowwrer,mowrer
mujahideen	mujahideeen,mujahideen
overshadowing	overshadowing
teenaged	teeenaged,teenaged
brawling	brawling
hollowness	hollowwness,hollowness
feeney	feeney
thudding	thuddding,thudding
perigee	perigeee,perigee
sainthood	sainthoood,sainthood
tepee	tepeee,tepee
narrowband	narrowwband,narrowband
giveaway	giveaway
stateroom	stateroom
bawled	bawwled,bawled
leering	leeering,leering
meeks	meeeks,meeks
coffeehouse	coffeeehouse,coffeehouse
coffees	coffeees,coffees
brawny	brawny
hoosier	hooosier,hoosier
saarinen	saaarinen,saarinen
oddest	oddest
saab	saaab,saab
taa	taaa,taa
choctaws	choctawws,choctaws
johnstown	johnstown
jawed	jawed
roomed	rooomed,roomed
nootka	noootka,nootka
bookbinding	boookbinding,bookbinding
sorrowing	sorrowwing,sorrowing
growls	growls
bloodiest	bloodiest
reeder	reeeder,reeder
childhoods	childhooods,childhoods
cloward	cloward
awakenings	awakenings
mcghee	mcghee
keele	keeele,keele
mckeown	mckeown
megiddo	megidddo,megiddo
scree	scree
sneers	sneers
howitt	howwitt,howitt
avow	avow
hagerstown	hagerstowwn,hagerstown
cooped	coooped,cooped
goodbyes	gooodbyes,goodbyes
sloops	sloops
tooled	toooled,tooled
cowie	cowwie,cowie
straddles	straddles
flowmeter	flowmeter
sapwood	sapwood
seethed	seeethed,seethed
elysees	elysees
greenough	greenough
aap	aaap,aap
privateering	privateering
townes	towwnes,townes
kapoor	kapooor,kapoor
cheeky	cheeeky,cheeky
downgrade	dowwngrade,downgrade
lndeed	lndeed
freezers	freezers
coulee	couleee,coulee
santee	santeee,santee
aalto	aaalto,aalto
bloor	bloor
hightower	hightowwer,hightower
teetering	teeetering,teetering
yoon	yooon,yoon
kleenex	kleenex
hardee	hardeee,hardee
bowring	bowwring,bowring
jeers	jeers
chowdhury	chowwdhury,chowdhury
staaten	staaten
squaws	squaws
cuddling	cudddling,cuddling
feedbacks	feedbacks
footstep	footstep
cheesecloth	cheeesecloth,cheesecloth
hoodlums	hooodlums,hoodlums
sharpshooters	sharpshooters
craddock	craddock
liddy	lidddy,liddy
leibowitz	leibowwitz,leibowitz
rootstock	roootstock,rootstock
meetinghouse	meeetinghouse,meetinghouse
awnings	awnings
reeked	reeeked,reeked
headdresses	headddresses,headdresses
crawler	crawler
vroom	vroom
chaffee	chaffeee,chaffee
powering	powwering,powering
dupree	dupreee,dupree
freest	freest
roosters	rooosters,roosters
greenbacks	greenbacks
stowage	stowage
supervisee	superviseee,supervisee
huddersfield	hudddersfield,huddersfield
lawman	lawwman,lawman
scrawl	scrawl
fowles	fowles
clowning	clowning
allee	allee
reevaluated	reeevaluated,reevaluated
meyerbeer	meyerbeeer,meyerbeer
elbowed	elbowed
blowout	blowout
middlebury	midddlebury,middlebury
cheerily	cheeerily,cheerily
bloomberg	bloomberg
menominee	menomineee,menominee
howsoever	howwsoever,howsoever
plowden	plowden
ecowas	ecowas
overblown	overblown
steelmaking	steelmaking
hornblower	hornblowwer,hornblower
seele	seeele,seele
doon	dooon,doon
brawls	brawls
milkweed	milkweed
reeducation	reeeducation,reeducation
antifreeze	antifreeze
brentwood	brentwood
toomer	tooomer,toomer
fallows	fallows
mcafee	mcafee
snowmobile	snowmobile
sooth	soooth,sooth
crowbar	crowbar
watchtower	watchtower
shredding	shredding
giddiness	giddiness
lunchroom	lunchrooom,lunchroom
eeo	eeeo,eeo
swidden	swidden
outgrowths	outgrowwths,outgrowths
bestowal	bestowwal,bestowal
mallow	malloww,mallow
ddd	ddd
cyclooxygenase	cycloooxygenase,cyclooxygenase
jubilees	jubilees
kawai	kawwai,kawai
hooligans	hoooligans,hooligans
twentythree	twentythree
siddons	sidddons,siddons
linlithgow	linlithgoww,linlithgow
knowhow	knowhow
leeuwen	leeeuwwen,leeuwen
hedgerow	hedgeroww,hedgerow
grandees	grandees
hayakawa	hayakawwa,hayakawa
pantaloons	pantalooons,pantaloons
beerbohm	beeerbohm,beerbohm
showmanship	showmanship
haa	haaa,haa
booklist	boooklist,booklist
macdowell	macdowwell,macdowell
honeybees	honeybeees,honeybees
speedway	speedway
screenplays	screenplays
isaacson	isaacson
graaff	graaff
prowled	prowled
ddl	ddl
honeybee	honeybeee,honeybee
typhoons	typhooons,typhoons
overdrawn	overdrawn
peacekeepers	peacekeeepers,peacekeepers
frisbee	frisbee
addressable	addressable
showcases	showcases
annee	annee
reawakening	reawwakening,reawakening
pawing	pawwing,pawing
gooseberry	goooseberry,gooseberry
stooges	stooges
overweening	overweening
moores	mooores,moores
weems	weems
mown	mowwn,mown
moodie	mooodie,moodie
allentown	allentown
sweetwater	sweetwater
stoddart	stoddart
coote	cooote,coote
dowden	dowwden,dowden
ridder	riddder,ridder
shaanxi	shaanxi
uwe	uwe
veen	veeen,veen
cottonwoods	cottonwoods
wootton	wootton
kurosawa	kurosawwa,kurosawa
staatliche	staatliche
qaddafi	qadddafi,qaddafi
footwork	footwork
gleeful	gleeful
lakewood	lakewood
coetzee	coetzeee,coetzee
saavedra	saaavedra,saavedra
highspeed	highspeeed,highspeed
deering	deeering,deering
moorhead	mooorhead,moorhead
brawn	brawn
dowson	dowwson,dowson
trawling	trawwling,trawling
kool	koool,kool
absentees	absentees
mushrooming	mushroooming,mushrooming
freestyle	freestyle
boor	booor,boor
howdy	howwdy,howdy
rapeseed	rapeseeed,rapeseed
griddle	griddle
swaddling	swaddling
henshaw	henshaww,henshaw
eee	eeee,eee
befuddled	befudddled,befuddled
wedderburn	wedderburn
deen	deeen,deen
nawaz	nawwaz,nawaz
iddm	iddm
cowered	cowwered,cowered
fellowmen	fellowmen
coomaraswamy	cooomaraswamy,coomaraswamy
kanawha	kanawwha,kanawha
footbridge	footbridge
bylaw	bylaww,bylaw
barroom	barrooom,barroom
greenbelt	greenbelt
ringwood	ringwood
ooooo	ooooooo,ooooo
dowdy	dowwdy,dowdy
sneezed	sneezed
noo	nooo,noo
spooked	spooked
beersheba	beeersheba,beersheba
looters	loooters,looters
looseleaf	loooseleaf,looseleaf
flowrate	flowrate
floodgates	floodgates
sweetmeats	sweetmeats
buccaneer	buccaneeer,buccaneer
trooped	troooped,trooped
middens	midddens,middens
downer	dowwner,downer
clawson	clawson
kook	koook,kook
homeownership	homeowwnership,homeownership
huddleston	hudddleston,huddleston
goon	gooon,goon
aat	aaat,aat
reentrant	reeentrant,reentrant
reenact	reeenact,reenact
marshmallow	marshmalloww,marshmallow
jeez	jeez
megawatts	megawwatts,megawatts
aaas	aaaas,aaas
dowell	dowwell,dowell
peet	peeet,peet
kaddish	kadddish,kaddish
whoops	whoops
zoologists	zoologists
granddaughters	granddaughters
laidlaw	laidlaww,laidlaw
queenie	queeenie,queenie
leeuw	leeeuww,leeuw
homeroom	homerooom,homeroom
coors	cooors,coors
booting	boooting,booting
snowshoe	snowshoe
andree	andree
sideshow	sideshoww,sideshow
hipaa	hipaaa,hipaa
mahmood	mahmoood,mahmood
seaworthy	seawworthy,seaworthy
wheeze	wheeze
billowed	billowwed,billowed
horwood	horwood
maddison	madddison,maddison
leeuwenhoek	leeeuwwenhoek,leeuwenhoek
catawba	catawwba,catawba
awestruck	awestruck
loosens	looosens,loosens
dinwiddie	dinwidddie,dinwiddie
clowes	clowes
heirlooms	heirloooms,heirlooms
redrawing	redrawwing,redrawing
kees	keees,kees
greenaway	greenaway
trow	troww,trow
glowering	glowering
renshaw	renshaww,renshaw
nakagawa	nakagawwa,nakagawa
logbook	logboook,logbook
seemly	seeemly,seemly
boole	booole,boole
geek	geeek,geek
kozlowski	kozlowwski,kozlowski
yow	yoww,yow
raab	raaab,raab
janowitz	janowitz
reemergence	reeemergence,reemergence
cooed	coooed,cooed
foothill	foothill
lookouts	loookouts,lookouts
divorcee	divorceee,divorcee
counselee	counseleee,counselee
unawareness	unawareness
sweezy	sweezy
adders	adders
boorstin	booorstin,boorstin
aal	aaal,aal
coos	cooos,coos
snoop	snoop
caddo	cadddo,caddo
haase	haaase,haase
freewheeling	freewheeling
foreseeability	foreseeability
weel	weel
stylesheet	stylesheet
facedown	facedown
schoolcraft	schoolcraft
cathleen	cathleeen,cathleen
sherbrooke	sherbrooke
awolowo	awolowo
peele	peeele,peele
keeton	keeeton,keeton
keeling	keeeling,keeling
needling	neeedling,needling
intraabdominal	intraabdominal
crookes	crookes
keesing	keeesing,keesing
oilseed	oilseeed,oilseed
shampoos	shampoos
mowat	mowwat,mowat
poorhouse	pooorhouse,poorhouse
braintree	braintree
snowdon	snowdon
downturns	dowwnturns,downturns
throwers	throwers
wildflower	wildflower
needlepoint	neeedlepoint,needlepoint
caw	caww,caw
schooldays	schooldays
seeman	seeeman,seeman
zoot	zoot
crawfish	crawfish
yawns	yawwns,yawns
freeland	freeland
granddad	granddad
niddm	nidddm,niddm
keeley	keeeley,keeley
nieuwe	nieuwwe,nieuwe
hadden	haddden,hadden
lowed	lowwed,lowed
marshmallows	marshmallowws,marshmallows
arrowsmith	arrowsmith
flaxseed	flaxseed
escapees	escapees
jowar	jowar
seedless	seeedless,seedless
leery	leeery,leery
barstow	barstoww,barstow
peddle	pedddle,peddle
beefy	beeefy,beefy
creech	creech
throwaway	throwaway
whirlpools	whirlpools
fiddlers	fiddlers
courtrooms	courtroooms,courtrooms
windowed	windowed
dawley	dawwley,dawley
ragweed	ragweed
howards	howwards,howards
scooters	scooters
showrooms	showrooms
bloomingdale	bloomingdale
soothes	sooothes,soothes
onslow	onslow
geelong	geeelong,geelong
spoor	spoor
sleepwalking	sleepwalking
preening	preening
preschooler	preschooler
windblown	windblown
queenstown	queeenstowwn,queenstown
streetlights	streetlights
sewanee	sewaneee,sewanee
browsed	browsed
profiteers	profiteers
overawed	overawed
downbeat	dowwnbeat,downbeat
teeter	teeeter,teeter
lefkowitz	lefkowwitz,lefkowitz
lidded	liddded,lidded
betook	betoook,betook
forsooth	forsooth
whoosh	whoosh
paddocks	padddocks,paddocks
rosenbloom	rosenblooom,rosenbloom
steeples	steeples
baas	baaas,baas
powwow	powwwoww,powwow
spoof	spoof
huddling	hudddling,huddling
wheelhouse	wheelhouse
greenbaum	greenbaum
oocysts	ooocysts,oocysts
yaws	yawws,yaws
siddha	sidddha,siddha
fawns	fawns
deeded	deeeded,deeded
coot	cooot,coot
dees	deees,dees
foodborne	foodborne
morgantown	morgantowwn,morgantown
townsville	towwnsville,townsville
spottiswoode	spottiswoode
floodlights	floodlights
schoolgirls	schoolgirls
storekeepers	storekeepers
manatee	manateee,manatee
saddlebags	sadddlebags,saddlebags
aws	aws
ingrowth	ingrowth
interbreeding	interbreeding
toole	tooole,toole
kanagawa	kanagawwa,kanagawa
feedwater	feedwater
woodhull	woodhull
supercooled	supercoooled,supercooled
annees	annees
peephole	peeephole,peephole
awaking	awaking
cooperstown	coooperstowwn,cooperstown
reawakened	reawwakened,reawakened
beeches	beeeches,beeches
noreen	noreeen,noreen
karoo	karooo,karoo
threeyear	threeyear
codebook	codeboook,codebook
goatee	goateee,goatee
gazetteers	gazetteeers,gazetteers
boxwood	boxwood
careening	careeening,careening
stowell	stowell
woodwinds	woodwinds
lowie	lowwie,lowie
oogenesis	ooogenesis,oogenesis
townsman	towwnsman,townsman
freelancers	freelancers
boorish	booorish,boorish
hopwood	hopwood
igloo	igloo
muddling	mudddling,muddling
beekman	beeekman,beekman
peeters	peeeters,peeters
hapgood	hapgoood,hapgood
boos	booos,boos
potawatomi	potawwatomi,potawatomi
greenback	greenback
tdd	tdd
yoshikawa	yoshikawwa,yoshikawa
cheesy	cheeesy,cheesy
bowyer	bowwyer,bowyer
maar	maaar,maar
backdoor	backdooor,backdoor
overshadows	overshadows
greenness	greenness
touchdowns	touchdowwns,touchdowns
addi	addi
baleen	baleeen,baleen
pawnbroker	pawwnbroker,pawnbroker
fiddles	fiddles
maarten	maaarten,maarten
consultee	consulteee,consultee
gooding	goooding,gooding
breastfeed	breastfeed
queers	queeers,queers
freeborn	freeborn
downloadable	dowwnloadable,downloadable
charlottetown	charlottetowwn,charlottetown
wladyslaw	wladyslaw
snowmelt	snowmelt
taw	taww,taw
rawdon	rawwdon,rawdon
fawkes	fawkes
woodard	woodard
gaa	gaaa,gaa
idees	idees
unseeing	unseeing
airpower	airpowwer,airpower
jawbone	jawbone
underflow	underflow
hookups	hoookups,hookups
goalkeeper	goalkeeeper,goalkeeper
ebook	ebook
tycoons	tycooons,tycoons
bioengineering	bioengineeering,bioengineering
bronislaw	bronislaw
caddie	cadddie,caddie
deerskin	deeerskin,deerskin
volunteerism	volunteeerism,volunteerism
footfalls	footfalls
seabrook	seabroook,seabrook
hawkeye	hawwkeye,hawkeye
letdown	letdowwn,letdown
storerooms	storerooms
muddied	mudddied,muddied
kneed	kneed
feelin	feelin
pureed	pureeed,pureed
cowries	cowwries,cowries
seely	seeely,seely
bulletproof	bulletprooof,bulletproof
corvee	corveee,corvee
bulow	buloww,bulow
taal	taaal,taal
townley	towwnley,townley
gowon	gowwon,gowon
veers	veeers,veers
auctioneers	auctioneeers,auctioneers
speedier	speedier
broomstick	broomstick
bootleg	boootleg,bootleg
soothsayer	sooothsayer,soothsayer
looker	loooker,looker
cloakroom	cloakroom
liddle	lidddle,liddle
stroop	stroop
grahamstown	grahamstown
beene	beeene,beene
moonless	mooonless,moonless
reemerged	reeemerged,reemerged
sweetening	sweetening
gabaa	gabaaa,gabaa
shawnees	shawnees
beekeeping	beeekeeeping,beekeeping
capetown	capetowwn,capetown
oozes	ooozes,oozes
toots	tooots,toots
ichikawa	ichikawa
goons	gooons,goons
downie	dowwnie,downie
sowell	sowwell,sowell
hoots	hooots,hoots
feedstocks	feedstocks
trelawny	trelawwny,trelawny
seest	seeest,seest
bloomers	bloomers
slaveowners	slaveowners
hindoos	hindooos,hindoos
schoolbooks	schoolbooks
coffeepot	coffeeepot,coffeepot
bloodbath	bloodbath
algaas	algaas
bedfellows	bedfellowws,bedfellows
groote	groote
walloon	walloon
thurow	thuroww,thurow
rowlandson	rowwlandson,rowlandson
allaah	allaah
cooperators	coooperators,cooperators
hookup	hoookup,hookup
europeenne	europeeenne,europeenne
pawed	pawwed,pawed
parolees	paroleees,parolees
littlewood	littlewood
rootedness	roootedness,rootedness
peddled	pedddled,peddled
creeley	creeley
rootstocks	roootstocks,rootstocks
piscataway	piscatawway,piscataway
dashwood	dashwood
beeper	beeeper,beeper
awt	awt
kiddie	kidddie,kiddie
greenhill	greenhill
wooldridge	wooldridge
spermatozoon	spermatozoon
wheelers	wheelers
oophorectomy	ooophorectomy,oophorectomy
wools	wools
woodville	woodville
pawned	pawwned,pawned
assignees	assignees
cawnpore	cawwnpore,cawnpore
pamphleteer	pamphleteeer,pamphleteer
keeney	keeeney,keeney
attwood	attwood
leeson	leeeson,leeson
festoons	festoons
squawk	squawk
workflows	workflows
chafee	chafeee,chafee
dataflow	datafloww,dataflow
cowrie	cowwrie,cowrie
amputee	amputee
beelzebub	beeelzebub,beelzebub
bestknown	bestknowwn,bestknown
woodlawn	woodlawn
waddled	waddled
joo	joo
draftees	draftees
woodsman	woodsman
cuddly	cudddly,cuddly
cranbrook	cranbrook
crowne	crowne
windowing	windowing
murfreesboro	murfreeesboro,murfreesboro
oot	ooot,oot
cookson	coookson,cookson
ranee	raneee,ranee
meed	meeed,meed
woodcutter	woodcutter
redd	reddd,redd
grameen	grameen
foodservice	foodservice
stokowski	stokowski
cheerleading	cheeerleading,cheerleading
mawson	mawwson,mawson
drool	drool
doorkeeper	dooorkeeeper,doorkeeper
broadsheet	broadsheet
looney	loooney,looney
tarawa	tarawwa,tarawa
wheelbase	wheelbase
williamstown	williamstown
woodhead	woodhead
spoonfuls	spoonfuls
bowsprit	bowwsprit,bowsprit
wildebeest	wildebeest
kiowas	kiowwas,kiowas
crooned	crooned
pownall	powwnall,pownall
goodfellow	gooodfelloww,goodfellow
wardroom	wardroom
flawlessly	flawlessly
softwoods	softwoods
granddaddy	granddaddy
seawall	seawwall,seawall
pensees	penseees,pensees
loons	looons,loons
soiree	soireee,soiree
hows	howws,hows
keely	keeely,keely
bassoons	bassooons,bassoons
keeled	keeeled,keeled
vaal	vaaal,vaal
acknowledg	acknowledg
toombs	tooombs,toombs
undertow	undertow
woodblock	woodblock
crooning	crooning
coops	cooops,coops
obligee	obligee
koopmans	kooopmans,koopmans
wadding	wadding
loony	looony,loony
bootstrapping	boootstrapping,bootstrapping
lawlor	lawwlor,lawlor
hooghly	hoooghly,hooghly
jowl	jowl
jeer	jeer
cookers	coookers,cookers
sowerby	sowwerby,sowerby
cower	cowwer,cower
refereed	refereeed,refereed
parakeet	parakeeet,parakeet
noontime	nooontime,noontime
dfee	dfee
steelworks	steelworks
buddhistic	budddhistic,buddhistic
ideen	ideen
ujamaa	ujamaa
teeny	teeeny,teeny
squawking	squawking
rootlets	roootlets,rootlets
snook	snook
toon	tooon,toon
caboose	cabooose,caboose
raad	raaad,raad
hookers	hoookers,hookers
siddhanta	sidddhanta,siddhanta
addisonwesley	addisonwesley
cowherd	cowwherd,cowherd
howrah	howwrah,howrah
gwynedd	gwynedd
lowliest	lowwliest,lowliest
reemployment	reeemployment,reemployment
keels	keeels,keels
neer	neeer,neer
meena	meeena,meena
leela	leeela,leela
feeler	feeler
maynooth	maynoooth,maynooth
thudded	thuddded,thudded
designee	designeee,designee
hooray	hoooray,hooray
broward	broward
chooser	choooser,chooser
sightseers	sightseeers,sightseers
ingaas	ingaas
graaf	graaf
irrawaddy	irrawaddy
stowing	stowing
cesspool	cesspoool,cesspool
addy	addy
ameer	ameer
tows	towws,tows
dalloway	dallowway,dalloway
noone	nooone,noone
riddance	ridddance,riddance
toothbrushes	tooothbrushes,toothbrushes
voorhees	vooorheees,voorhees
spee	spee
codd	coddd,codd
spawns	spawns
predawn	predawn
roomful	rooomful,roomful
greenock	greenock
careened	careeened,careened
surtees	surteees,surtees
bigfoot	bigfooot,bigfoot
gooey	goooey,gooey
booed	boooed,booed
keepsake	keeepsake,keepsake
moonlighting	mooonlighting,moonlighting
incoordination	incoordination
bowditch	bowwditch,bowditch
jaworski	jaworski
moorman	mooorman,moorman
megawatt	megawwatt,megawatt
boerhaave	boerhaaave,boerhaave
harpoons	harpooons,harpoons
koop	kooop,koop
lampoon	lampooon,lampoon
adduces	adduces
lowrie	lowwrie,lowrie
gowan	gowwan,gowan
lowpass	lowwpass,lowpass
gamekeeper	gamekeeeper,gamekeeper
proofreader	proofreader
pontoons	pontooons,pontoons
freemason	freemason
hazelwood	hazelwood
goodell	gooodell,goodell
kawamura	kawwamura,kawamura
brokaw	brokaw
pawnees	pawwneees,pawnees
longwood	longwood
hooliganism	hoooliganism,hooliganism
shree	shree
preestablished	preestablished
uddi	uddi
feebleminded	feebleminded
pardee	pardeee,pardee
stooge	stooge
poon	pooon,poon
schooler	schooler
midnineteenth	midnineteeenth,midnineteenth
teemed	teeemed,teemed
jee	jee
steedman	steedman
freewill	freewill
okinawan	okinawan
chattahoochee	chattahooocheee,chattahoochee
lackawanna	lackawwanna,lackawanna
saeed	saeeed,saeed
freeboard	freeboard
rookery	roookery,rookery
ddp	ddp
followings	followings
schoolers	schoolers
cooperativity	coooperativity,cooperativity
glenwood	glenwood
sixteenthcentury	sixteeenthcentury,sixteenthcentury
wallowed	wallowed
bookkeepers	boookkeeepers,bookkeepers
spoofing	spoofing
downswing	dowwnswing,downswing
shakedown	shakedown
kawakami	kawwakami,kawakami
wildwood	wildwood
unhooked	unhooked
gooseberries	goooseberries,gooseberries
bloodline	bloodline
baath	baaath,baath
wadded	wadded
aau	aaau,aau
lowes	lowwes,lowes
cockatoo	cockatooo,cockatoo
rabinow	rabinoww,rabinow
widdowson	widdowson
oxbow	oxbow
woodbine	woodbine
jowls	jowls
aam	aaam,aam
crashaw	crashaw
toffee	toffeee,toffee
puppeteer	puppeteeer,puppeteer
zoospores	zoospores
downplaying	dowwnplaying,downplaying
windowpane	windowpane
subtrees	subtreees,subtrees
oort	ooort,oort
earnshaw	earnshaww,earnshaw
backflow	backfloww,backflow
meech	meeech,meech
reeks	reeeks,reeks
letterbook	letterboook,letterbook
rockwood	rockwood
snowballs	snowballs
goodson	gooodson,goodson
toomey	tooomey,toomey
redden	reddden,redden
roosts	rooosts,roosts
teetered	teeetered,teetered
outlawry	outlawwry,outlawry
gleeson	gleeson
bowstring	bowwstring,bowstring
investee	investee
perrow	perroww,perrow
truckee	truckeee,truckee
jawahar	jawahar
footloose	footloose
mccook	mccook
schoolmate	schoolmate
moorehead	mooorehead,moorehead
beeson	beeeson,beeson
threesome	threesome
bowlers	bowwlers,bowlers
doorsteps	dooorsteps,doorsteps
kitagawa	kitagawwa,kitagawa
easterbrook	easterbroook,easterbrook
loopback	looopback,loopback
wheezed	wheezed
supercooling	supercoooling,supercooling
tooley	toooley,tooley
townsite	towwnsite,townsite
kanazawa	kanazawwa,kanazawa
munksgaard	munksgaaard,munksgaard
browed	browed
soothsayers	sooothsayers,soothsayers
arrowroot	arrowroot
maddalena	madddalena,maddalena
unredeemed	unredeemed
palawan	palawwan,palawan
deepak	deeepak,deepak
owi	owi
peeler	peeeler,peeler
typee	typeee,typee
grownup	grownup
gamow	gamoww,gamow
howlett	howwlett,howlett
benbow	benboww,benbow
jamaat	jamaat
knowers	knowers
sheeted	sheeted
donnees	donneees,donnees
museen	museeen,museen
bridgetown	bridgetown
bowser	bowwser,bowser
disallowing	disallowwing,disallowing
shirtsleeves	shirtsleeves
tedder	teddder,tedder
eet	eeet,eet
feedlot	feedlot
leet	leeet,leet
hollowing	hollowwing,hollowing
jeeves	jeeves
goodhart	gooodhart,goodhart
coffeehouses	coffeeehouses,coffeehouses
saatchi	saaatchi,saatchi
vdd	vdd
lowi	lowwi,lowi
fedayeen	fedayeen
jarrow	jarrow
abramowitz	abramowitz
furukawa	furukawa
wildfowl	wildfowl
swooning	swooning
bloodhound	bloodhound
amputees	amputees
laocoon	laocooon,laocoon
buffoonery	buffooonery,buffoonery
cheekbone	cheeekbone,cheekbone
meehl	meeehl,meehl
misdeed	misdeeed,misdeed
keening	keeening,keening
howler	howwler,howler
gladdened	gladdened
foodgrain	foodgrain
geen	geeen,geen
supervisees	superviseees,supervisees
spleens	spleens
woodchuck	woodchuck
arawak	arawak
racketeers	racketeeers,racketeers
ower	ower
shawcross	shawcross
woolens	woolens
hawkesbury	hawwkesbury,hawkesbury
zooms	zooms
banshee	bansheee,banshee
scoot	scoot
townhouses	towwnhouses,townhouses
kickapoo	kickapooo,kickapoo
castaways	castawways,castaways
screenwriters	screenwriters
bukowski	bukowwski,bukowski
overshooting	overshooting
aaup	aaaup,aaup
lawmen	lawwmen,lawmen
babyhood	babyhoood,babyhood
committeeman	committeeeman,committeeman
torchbooks	torchboooks,torchbooks
headroom	headrooom,headroom
bardeen	bardeeen,bardeen
baader	baaader,baader
scow	scow
showcased	showcased
highschool	highschoool,highschool
coombe	cooombe,coombe
wolfowitz	wolfowitz
nonfood	nonfoood,nonfood
queensberry	queeensberry,queensberry
spaatz	spaatz
rooke	roooke,rooke
freestone	freestone
floodwaters	floodwaters
moonstone	mooonstone,moonstone
addled	addled
boobs	booobs,boobs
koopman	kooopman,koopman
deena	deeena,deena
unschooled	unschooled
distributee	distributeee,distributee
yukawa	yukawwa,yukawa
larrabee	larrabeee,larrabee
soirees	soireees,soirees
awls	awls
moodiness	mooodiness,moodiness
ballooned	balloooned,ballooned
noncooperation	noncoooperation,noncooperation
shooed	shooed
bloodstains	bloodstains
shutdowns	shutdowns
wintergreen	wintergreen
goof	gooof,goof
hardihood	hardihoood,hardihood
tarrytown	tarrytowwn,tarrytown
beekeepers	beeekeeepers,beekeepers
garrow	garroww,garrow
meow	meoww,meow
paar	paaar,paar
youngblood	youngbloood,youngblood
tabooed	taboooed,tabooed
caddis	cadddis,caddis
christiaan	christiaan
knowl	knowl
castaway	castawway,castaway
deerslayer	deeerslayer,deerslayer
oolitic	ooolitic,oolitic
beeps	beeeps,beeps
starfleet	starfleet
lawmaker	lawwmaker,lawmaker
beefsteak	beeefsteak,beefsteak
awol	awol
boons	booons,boons
feddans	feddans
moodily	mooodily,moodily
saami	saaami,saami
saddler	sadddler,saddler
prowler	prowler
aberdeenshire	aberdeenshire
preece	preece
scowcroft	scowcroft
disempowered	disempowwered,disempowered
noncooperative	noncoooperative,noncooperative
coomassie	cooomassie,coomassie
hosokawa	hosokawwa,hosokawa
elmwood	elmwood
footholds	footholds
reebok	reeebok,reebok
bootlegging	boootlegging,bootlegging
macaw	macaww,macaw
naaman	naaaman,naaman
kenwood	kenwood
legatees	legateees,legatees
lawrie	lawwrie,lawrie
fanshawe	fanshawe
koontz	kooontz,koontz
paddlers	padddlers,paddlers
parolee	paroleee,parolee
wooley	wooley
fleecy	fleecy
grooving	grooving
freeware	freeware
bawl	bawwl,bawl
oom	ooom,oom
brooker	brooker
siddhi	sidddhi,siddhi
northbrook	northbroook,northbrook
soddy	sodddy,soddy
flamsteed	flamsteed
goddammit	godddammit,goddammit
woodley	woodley
leeper	leeeper,leeper
feelingly	feelingly
pawtucket	pawwtucket,pawtucket
daewoo	daewoo
aai	aaai,aai
oakwood	oakwood
reexamining	reeexamining,reexamining
hangchow	hangchoww,hangchow
bowmen	bowwmen,bowmen
woolman	woolman
medawar	medawwar,medawar
goodlooking	gooodloooking,goodlooking
rudders	ruddders,rudders
graal	graal
reddi	redddi,reddi
bloodhounds	bloodhounds
schoolwide	schoolwide
goodnow	gooodnoww,goodnow
bootleggers	boootleggers,bootleggers
dooms	doooms,dooms
downstage	dowwnstage,downstage
crooke	crooke
shallowly	shallowly
shootout	shootout
woodall	woodall
towner	towwner,towner
chickadee	chickadeee,chickadee
coogan	cooogan,coogan
swaddled	swaddled
eichengreen	eichengreeen,eichengreen
coopted	cooopted,coopted
rowse	rowwse,rowse
beeline	beeeline,beeline
hinshaw	hinshaww,hinshaw
muskogee	muskogeee,muskogee
kow	koww,kow
cooptation	coooptation,cooptation
goodspeed	gooodspeeed,goodspeed
vedder	veddder,vedder
jastrow	jastrow
peeps	peeeps,peeps
swooned	swooned
smokescreen	smokescreen
budded	buddded,budded
lawbreakers	lawwbreakers,lawbreakers
woodburn	woodburn
adoptee	adoptee
cuckoos	cuckooos,cuckoos
bloodlines	bloodlines
oor	ooor,oor
veena	veeena,veena
owain	owain
agreeableness	agreeableness
hallows	hallowws,hallows
selfawareness	selfawwareness,selfawareness
spooned	spooned
geeta	geeeta,geeta
showpiece	showpiece
pawnshop	pawwnshop,pawnshop
bumblebee	bumblebeee,bumblebee
preschools	preschools
awg	awg
gatewood	gatewood
boothby	booothby,boothby
teem	teeem,teem
cookware	coookware,cookware
nowe	nowwe,nowe
breslow	breslow
seeth	seeeth,seeth
goodlad	gooodlad,goodlad
basswood	basswood
goodale	gooodale,goodale
keefer	keeefer,keefer
slaw	slaw
lwow	lwow
waddling	waddling
dropdown	dropdown
whooped	whooped
saleem	saleeem,saleem
coord	cooord,coord
daa	daaa,daa
wheelbarrows	wheelbarrows
seethe	seeethe,seethe
pdd	pdd
aaai	aaaai,aaai
awk	awk
katowice	katowwice,katowice
bisbee	bisbeee,bisbee
puddling	pudddling,puddling
veneered	veneeered,veneered
footplate	footplate
snooze	snooze
spaak	spaak
paratrooper	paratroooper,paratrooper
woodpile	woodpile
woodshed	woodshed
stateowned	stateowned
drawstring	drawstring
sawyers	sawwyers,sawyers
heeft	heeeft,heeft
rowling	rowwling,rowling
hooch	hoooch,hooch
browner	browner
beery	beeery,beery
gatekeeping	gatekeeeping,gatekeeping
middles	midddles,middles
owings	owings
lowestoft	lowwestoft,lowestoft
carlow	carloww,carlow
brawley	brawley
wadden	wadden
aaaa	aaaaaa,aaaa
embree	embree
seemeth	seeemeth,seemeth
downregulation	dowwnregulation,downregulation
meddlesome	medddlesome,meddlesome
twee	twee
reentering	reeentering,reentering
steelers	steelers
eaa	eaaa,eaa
smoothest	smoothest
decreeing	decreeeing,decreeing
tweeds	tweeds
wooten	wooten
ceecs	ceeecs,ceecs
eer	eeer,eer
smooths	smooths
mowry	mowwry,mowry
goodnatured	gooodnatured,goodnatured
dowsing	dowwsing,dowsing
ironwood	ironwood
chapbook	chapboook,chapbook
bdd	bdd
kareem	kareeem,kareem
hawkish	hawwkish,hawkish
carrageenan	carrageeenan,carrageenan
rookies	roookies,rookies
tearoom	tearooom,tearoom
bhawan	bhawan
boob	booob,boob
poolside	pooolside,poolside
pillowcase	pillowwcase,pillowcase
bookie	boookie,bookie
committeemen	committeeemen,committeemen
mendeleev	mendeleeev,mendeleev
schillebeeckx	schillebeeckx
beetroot	beeetrooot,beetroot
grabowski	grabowski
snowmobiles	snowmobiles
freethinkers	freethinkers
maat	maaat,maat
timekeeping	timekeeeping,timekeeping
kneecap	kneecap
groovy	groovy
weedon	weedon
timekeeper	timekeeeper,timekeeper
howden	howwden,howden
greenhorn	greenhorn
likelihoods	likelihooods,likelihoods
edgewood	edgewood
henslowe	henslowwe,henslowe
homeschooling	homeschoooling,homeschooling
middelburg	midddelburg,middelburg
footfall	footfall
bowerman	bowwerman,bowerman
fellowes	fellowes
dawa	dawwa,dawa
bookbinder	boookbinder,bookbinder
awacs	awacs
tomorrows	tomorrowws,tomorrows
dawdling	dawwdling,dawdling
drawingroom	drawingroom
chickasaws	chickasawws,chickasaws
cedaw	cedaww,cedaw
wardlaw	wardlaw
bawerk	bawwerk,bawerk
laa	laaa,laa
minesweepers	minesweepers
blakeslee	blakeslee
holyrood	holyroood,holyrood
unlooked	unlooked
drowsily	drowsily
droopy	droopy
doorframe	dooorframe,doorframe
oon	ooon,oon
woodworkers	woodworkers
sledding	sledding
hawked	hawwked,hawked
zebedee	zebedee
reflow	refloww,reflow
foolscap	foolscap
craw	craw
mallee	malleee,mallee
leesburg	leeesburg,leesburg
howse	howwse,howse
jazeera	jazeera
chainsaw	chainsaww,chainsaw
maddeningly	madddeningly,maddeningly
hallow	halloww,hallow
spooks	spooks
owsley	owsley
cowden	cowwden,cowden
overstreet	overstreet
poodles	pooodles,poodles
middlesbrough	midddlesbrough,middlesbrough
jawa	jawa
aae	aaae,aae
micawber	micawwber,micawber
spotswood	spotswood
roofless	rooofless,roofless
oddball	oddball
jonestown	jonestown
foochow	foochow
mortgagees	mortgageees,mortgagees
backroom	backrooom,backroom
eeuw	eeeuww,eeuw
pocketbooks	pocketboooks,pocketbooks
hooligan	hoooligan,hooligan
redbook	redboook,redbook
benteen	benteeen,benteen
electroweak	electroweak
fowling	fowling
brownfield	brownfield
seel	seeel,seel
irredeemable	irredeemable
tureen	tureeen,tureen
hoodlum	hooodlum,hoodlum
lowa	lowwa,lowa
willowy	willowy
miyazawa	miyazawwa,miyazawa
kiddush	kidddush,kiddush
lawd	lawwd,lawd
midweek	midweek
oost	ooost,oost
goodchild	gooodchild,goodchild
reefer	reeefer,reefer
louw	louww,louw
adda	adda
pamphleteers	pamphleteeers,pamphleteers
powerpc	powwerpc,powerpc
rickshaws	rickshawws,rickshaws
maddock	madddock,maddock
scheele	scheele
deedee	deeedeee,deedee
elizabethtown	elizabethtown
greenhalgh	greenhalgh
windowpanes	windowpanes
coordinative	cooordinative,coordinative
nowise	nowwise,nowise
rodd	roddd,rodd
seeckt	seeeckt,seeckt
steeping	steeping
kidded	kiddded,kidded
gawking	gawwking,gawking
streetlight	streetlight
twaddle	twaddle
isaak	isaak
kawaguchi	kawwaguchi,kawaguchi
aav	aaav,aav
doordarshan	dooordarshan,doordarshan
goodhue	gooodhue,goodhue
joos	joos
knowland	knowland
queenly	queeenly,queenly
powerplant	powwerplant,powerplant
racketeer	racketeeer,racketeer
kiddies	kidddies,kiddies
beddoes	bedddoes,beddoes
beek	beeek,beek
betweens	betweens
crees	crees
freeholder	freeholder
toothy	tooothy,toothy
showtime	showtime
clubfoot	clubfoot
spedding	spedding
knowe	knowe
mdd	mdd
hiaa	hiaaa,hiaa
needleman	neeedleman,needleman
kathiawar	kathiawwar,kathiawar
sneed	sneed
threefourths	threefourths
soonest	sooonest,soonest
joost	joost
beekeeper	beeekeeeper,beekeeper
crawlers	crawlers
ftaa	ftaa
beehives	beeehives,beehives
merimee	merimeee,merimee
deel	deeel,deel
hoofed	hooofed,hoofed
disproof	disprooof,disproof
hadde	haddde,hadde
powderly	powwderly,powderly
jezreel	jezreel
europeen	europeeen,europeen
haakon	haaakon,haakon
schoolmistress	schoolmistress
hacksaw	hacksaww,hacksaw
seein	seeein,seein
preexistent	preexistent
rockaway	rockawway,rockaway
seebohm	seeebohm,seebohm
suttee	sutteee,suttee
parakeets	parakeeets,parakeets
geez	geeez,geez
marketeers	marketeeers,marketeers
disallows	disallowws,disallows
aaronson	aaaronson,aaronson
invitees	invitees
weekes	weekes
grotowski	grotowski
eells	eeells,eells
blowdown	blowdown
duree	dureee,duree
rhondda	rhondda
moorhouse	mooorhouse,moorhouse
hawtrey	hawwtrey,hawtrey
downsized	dowwnsized,downsized
ween	ween
tomahawks	tomahawwks,tomahawks
selfknowledge	selfknowwledge,selfknowledge
holbrooke	holbroooke,holbrooke
fukuzawa	fukuzawa
towson	towwson,towson
teems	teeems,teems
footballer	footballer
nonpoor	nonpooor,nonpoor
goodwood	gooodwood,goodwood
kiddo	kidddo,kiddo
factbook	factbook
ingrown	ingrown
boothe	booothe,boothe
leered	leeered,leered
raaf	raaaf,raaf
dowding	dowwding,dowding
snoopy	snoopy
sowers	sowwers,sowers
crowfoot	crowfoot
metaanalysis	metaaanalysis,metaanalysis
kagawa	kagawwa,kagawa
heere	heeere,heere
swoops	swoops
cheeseburger	cheeeseburger,cheeseburger
greely	greely
saddling	sadddling,saddling
waddle	waddle
passbook	passboook,passbook
paratroops	paratrooops,paratroops
skeet	skeet
transferees	transfereees,transferees
peed	peeed,peed
scrimshaw	scrimshaw
noddings	nodddings,noddings
squawked	squawked
sneezes	sneezes
threepenny	threepenny
aag	aaag,aag
cheetahs	cheeetahs,cheetahs
godowns	godowwns,godowns
bowley	bowwley,bowley
bootstraps	boootstraps,bootstraps
knockdown	knockdown
andreev	andreev
careerists	careeerists,careerists
crossbreeding	crossbreeding
cowpox	cowwpox,cowpox
sickroom	sickrooom,sickroom
wydawnictwo	wydawnictwo
cheetham	cheeetham,cheetham
trooping	troooping,trooping
meddled	medddled,meddled
isee	isee
bazooka	bazoooka,bazooka
kawabata	kawwabata,kawabata
dawe	dawwe,dawe
gaddi	gadddi,gaddi
mackinaw	mackinaww,mackinaw
boosey	booosey,boosey
bookmakers	boookmakers,bookmakers
tablespoonful	tablespooonful,tablespoonful
hoon	hooon,hoon
mukerjee	mukerjeee,mukerjee
looke	loooke,looke
kingstown	kingstowwn,kingstown
greenbrier	greenbrier
evacuee	evacuee
subfloor	subflooor,subfloor
greenlanders	greenlanders
fleeces	fleeces
awad	awad
threescore	threescore
shootin	shootin
gowned	gowwned,gowned
eddying	eddying
gawd	gawwd,gawd
thirtythree	thirtythreee,thirtythree
unaddressed	unaddressed
manatees	manateees,manatees
arrestee	arrestee
cowes	cowwes,cowes
shopfloor	shopfloor
bookmaker	boookmaker,bookmaker
teed	teeed,teed
prophethood	prophethood
intraarticular	intraarticular
jamboree	jamboree
grandee	grandee
ddi	ddi
trueblood	truebloood,trueblood
bookes	boookes,bookes
ogee	ogee
siddiqui	sidddiqui,siddiqui
musees	museees,musees
woollcott	woollcott
needled	neeedled,needled
skoog	skoog
songbook	songboook,songbook
reemerge	reeemerge,reemerge
careen	careeen,careen
izaak	izaak
enrollee	enrollee
coddled	codddled,coddled
lawe	lawwe,lawe
bookselling	boookselling,bookselling
woollens	woollens
suhrawardy	suhrawwardy,suhrawardy
piltdown	piltdowwn,piltdown
yawl	yawwl,yawl
mazdoor	mazdooor,mazdoor
hoopla	hooopla,hoopla
bleecker	bleecker
helpee	helpeee,helpee
lawyering	lawwyering,lawyering
gridded	gridded
booz	boooz,booz
catherwood	catherwood
eegs	eeegs,eegs
diningroom	diningrooom,diningroom
schoolhouses	schoolhouses
fallowing	fallowing
southwood	southwood
awoken	awoken
lawford	lawwford,lawford
raa	raaa,raa
jaar	jaar
awn	awn
skeeter	skeeter
dowex	dowwex,dowex
arakawa	arakawa
elysee	elysee
doody	dooody,doody
steeplechase	steeplechase
businessweek	businessweek
speedboat	speedboat
hooft	hoooft,hooft
rowbotham	rowwbotham,rowbotham
cowhide	cowwhide,cowhide
garwood	garwood
duveen	duveeen,duveen
greenham	greenham
chickadees	chickadeees,chickadees
dungarees	dungareees,dungarees
kootenay	koootenay,kootenay
northwood	northwood
maass	maaass,maass
patentees	patenteees,patentees
inglewood	inglewood
eets	eeets,eets
mittee	mitteee,mittee
showcasing	showcasing
volksraad	volksraaad,volksraad
rawlsian	rawwlsian,rawlsian
sheena	sheena
oddi	oddi
keepe	keeepe,keepe
snooker	snooker
jaffee	jaffee
swallowtail	swallowtail
poof	pooof,poof
epizootic	epizootic
superadded	superaddded,superadded
sunscreens	sunscreeens,sunscreens
ravenswood	ravenswood
choosy	chooosy,choosy
tweedy	tweedy
clownish	clownish
disempowerment	disempowwerment,disempowerment
minow	minoww,minow
doormat	dooormat,doormat
deepseated	deeepseated,deepseated
tootsie	toootsie,tootsie
hoodwinked	hooodwinked,hoodwinked
packwood	packwood
screed	screed
cashflow	cashfloww,cashflow
shredder	shredder
berween	berween
oaa	oaaa,oaa
steere	steere
cooperativeness	coooperativeness,cooperativeness
blowpipe	blowpipe
toweling	towweling,toweling
nishikawa	nishikawwa,nishikawa
tsee	tsee
kaw	kaww,kaw
lawnmower	lawwnmowwer,lawnmower
zoomorphic	zoomorphic
brownmiller	brownmiller
coddling	codddling,coddling
steersman	steersman
bawa	bawwa,bawa
doodling	dooodling,doodling
cowbird	cowwbird,cowbird
bumblebees	bumblebeees,bumblebees
seaworthiness	seawworthiness,seaworthiness
papeete	papeeete,papeete
steelwork	steelwork
ahluwalia	ahluwalia
greediness	greediness
staatsbibliothek	staatsbibliothek
thaws	thawws,thaws
bootlegger	boootlegger,bootlegger
cartwheel	cartwheeel,cartwheel
kawashima	kawwashima,kawashima
kuwaitis	kuwwaitis,kuwaitis
virchows	virchowws,virchows
harrows	harrowws,harrows
lowy	lowwy,lowy
twoway	twoway
teece	teeece,teece
jankowski	jankowski
levittown	levittowwn,levittown
hawser	hawwser,hawser
geeks	geeeks,geeks
stringfellow	stringfellow
smithereens	smithereens
mees	meees,mees
haart	haaart,haart
beeping	beeeping,beeping
untrodden	untrodden
pingree	pingreee,pingree
keeble	keeeble,keeble
maumee	maumeee,maumee
arrowed	arrowed
howbeit	howwbeit,howbeit
beseeched	beseeeched,beseeched
lowliness	lowwliness,lowliness
mccawley	mccawley
lowdown	lowwdowwn,lowdown
tanglewood	tanglewood
winnowed	winnowed
stockroom	stockroom
eerste	eeerste,eerste
pinewood	pinewood
overawe	overawe
geert	geeert,geert
snowstorms	snowstorms
boddy	bodddy,boddy
parsee	parseee,parsee
farooq	farooq
elbowing	elbowing
aab	aaab,aab
tyree	tyreee,tyree
sheepdog	sheepdog
breezed	breezed
feer	feer
owa	owa
bradlee	bradlee
freethinker	freethinker
counterflow	counterfloww,counterflow
moog	mooog,moog
divorcees	divorceees,divorcees
downstate	dowwnstate,downstate
tooting	toooting,tooting
seealso	seeealso,seealso
eero	eeero,eero
soundproof	soundprooof,soundproof
odder	odder
feedstuffs	feedstuffs
disavowing	disavowwing,disavowing
woogie	woogie
goodin	gooodin,goodin
tepees	tepeees,tepees
nanowires	nanowwires,nanowires
sweeny	sweeny
adducing	adducing
gawk	gawwk,gawk
pawley	pawwley,pawley
doob	dooob,doob
staal	staal
eeprom	eeeprom,eeprom
sokolow	sokoloww,sokolow
unbeknown	unbeknown
goodpasture	gooodpasture,goodpasture
aashto	aaashto,aashto
troubleshooter	troubleshoooter,troubleshooter
liebowitz	liebowwitz,liebowitz
awadh	awadh
freewriting	freewriting
guffaw	guffaww,guffaw
ebooks	ebooks
screenwriting	screenwriting
cooch	coooch,cooch
rootlessness	roootlessness,rootlessness
kaaba	kaaaba,kaaba
plowshares	plowshares
ool	oool,ool
cawley	cawwley,cawley
pledgee	pledgee
cowperwood	cowwperwood,cowperwood
rowohlt	rowwohlt,rowohlt
rasheed	rasheeed,rasheed
showplace	showplace
madding	maddding,madding
goshawk	goshawwk,goshawk
hooton	hoooton,hooton
braidwood	braidwood
whistleblower	whistleblower
gansevoort	gansevooort,gansevoort
bitterroot	bitterrooot,bitterroot
footballers	footballers
aronowitz	aronowitz
waw	waw
bookmaking	boookmaking,bookmaking
scudding	scudding
glidden	glidden
heeling	heeeling,heeling
harewood	harewood
coddington	codddington,coddington
shedd	shedd
snowboarding	snowboarding
bronowski	bronowski
roosevelts	rooosevelts,roosevelts
coreldraw	coreldraww,coreldraw
mookerjee	moookerjeee,mookerjee
rower	rowwer,rower
teenth	teeenth,teenth
oroonoko	oroonoko
harlowe	harlowwe,harlowe
hoodoo	hooodooo,hoodoo
trincomalee	trincomaleee,trincomalee
hoopes	hooopes,hoopes
breese	breese
greenlee	greenlee
goossens	gooossens,goossens
stepladder	stepladder
ashdown	ashdown
townscape	towwnscape,townscape
zoologie	zoologie
taddeo	tadddeo,taddeo
snowdrifts	snowdrifts
aalborg	aaalborg,aalborg
crossbows	crossbows
coole	cooole,coole
dunaway	dunawway,dunaway
parsees	parseees,parsees
careerist	careeerist,careerist
wooly	wooly
footwall	footwall
coleslaw	coleslaww,coleslaw
reawaken	reawwaken,reawaken
devisee	deviseee,devisee
riddling	ridddling,riddling
slideshow	slideshow
matinees	matineees,matinees
assemblee	assemblee
diddle	didddle,diddle
gitlow	gitlow
awwa	awwa
freebooters	freebooters
udders	udders
sharpshooter	sharpshooter
greenacre	greenacre
maatschappij	maaatschappij,maatschappij
sprees	sprees
flowsheet	flowsheet
middlebrook	midddlebroook,middlebrook
tarrow	tarroww,tarrow
oooh	ooooh,oooh
greenwillow	greenwillow
peeved	peeeved,peeved
snowpack	snowpack
coorg	cooorg,coorg
buffoons	buffooons,buffoons
doorjamb	dooorjamb,doorjamb
kantorowicz	kantorowwicz,kantorowicz
threepence	threepence
blackhawk	blackhawk
gawky	gawwky,gawky
followeth	followeth
raabe	raaabe,raabe
lowcost	lowwcost,lowcost
retooling	retoooling,retooling
knowledgeably	knowledgeably
streetwise	streetwise
hullabaloo	hullabalooo,hullabaloo
bungee	bungeee,bungee
pauw	pauww,pauw
sawada	sawwada,sawada
bowe	bowwe,bowe
voorhis	vooorhis,voorhis
fenugreek	fenugreek
puppeteers	puppeteeers,puppeteers
zeeb	zeeb
chowk	chowwk,chowk
yellowknife	yellowwknife,yellowknife
bleeder	bleeder
freese	freese
negligee	negligeee,negligee
macqueen	macqueeen,macqueen
lawgivers	lawwgivers,lawgivers
meera	meeera,meera
ashbee	ashbee
woodcarving	woodcarving
preempts	preempts
maanen	maaanen,maanen
harrassowitz	harrassowwitz,harrassowitz
townland	towwnland,townland
treeline	treeeline,treeline
rowlatt	rowwlatt,rowlatt
towle	towwle,towle
linwood	linwood
iooo	ioooo,iooo
monooxygenase	monoooxygenase,monooxygenase
aah	aaah,aah
lampooned	lampoooned,lampooned
overpowers	overpowers
seene	seeene,seene
wheedling	wheedling
mcnamee	mcnamee
raintree	raintreee,raintree
flowmeters	flowmeters
victimhood	victimhoood,victimhood
reevaluating	reeevaluating,reevaluating
undercooling	undercooling
boorman	booorman,boorman
kraals	kraals
nieuw	nieuww,nieuw
toone	tooone,toone
godden	goddden,godden
velveteen	velveteeen,velveteen
caddies	cadddies,caddies
medd	meddd,medd
neediness	neeediness,neediness
saybrook	saybroook,saybrook
sawfly	sawwfly,sawfly
bookworm	boookworm,bookworm
scheel	scheel
spooning	spooning
weeklong	weeklong
preen	preen
sawai	sawwai,sawai
unpeeled	unpeeled
ruddick	rudddick,ruddick
bookchin	boookchin,bookchin
proofed	proofed
brownlie	brownlie
lowman	lowwman,lowman
alloway	alloway
pattee	patteee,pattee
mellowing	mellowwing,mellowing
altoona	altoona
showmen	showmen
noord	nooord,noord
taproot	taprooot,taproot
mcneely	mcneely
smoothie	smoothie
massawa	massawwa,massawa
looses	loooses,looses
deemphasized	deeemphasized,deemphasized
chapbooks	chapboooks,chapbooks
khoo	khooo,khoo
eek	eeek,eek
hawkesworth	hawwkesworth,hawkesworth
drawling	drawling
lowrey	lowwrey,lowrey
beeped	beeeped,beeped
snooty	snooty
feebler	feebler
looper	loooper,looper
pulldown	pulldowwn,pulldown
guffawed	guffawwed,guffawed
adriaan	adriaan
doodles	dooodles,doodles
saal	saaal,saal
lawley	lawwley,lawley
wittkower	wittkower
puddled	pudddled,puddled
deemphasize	deeemphasize,deemphasize
rawness	rawwness,rawness
kamloops	kamlooops,kamloops
fowle	fowle
degroot	degrooot,degroot
adderley	adderley
proudfoot	proudfoot
howson	howwson,howson
yellowfin	yellowwfin,yellowfin
riebeeck	riebeeeck,riebeeck
saddlebag	sadddlebag,saddlebag
smalltown	smalltown
uwb	uwb
foredoomed	foredoomed
lookers	loookers,lookers
wuthnow	wuthnow
greenberger	greenberger
queerness	queeerness,queerness
coover	cooover,coover
bowra	bowwra,bowra
sawa	sawwa,sawa
crookedly	crookedly
haddington	hadddington,haddington
saadia	saaadia,saadia
greenlandic	greenlandic
sleeman	sleeman
howley	howwley,howley
consignees	consigneees,consignees
bleeker	bleeker
roundwood	roundwood
calderwood	calderwood
soochow	sooochoww,soochow
snowbound	snowbound
guwahati	guwwahati,guwahati
sprawls	sprawls
ballrooms	ballroooms,ballrooms
markdowns	markdowwns,markdowns
heedlessly	heeedlessly,heedlessly
coordinations	cooordinations,coordinations
unfreedom	unfreedom
dawdle	dawwdle,dawdle
daddies	dadddies,daddies
reemphasized	reeemphasized,reemphasized
weatherproof	weatherproof
yahoos	yahooos,yahoos
okeechobee	okeechobee
staw	staw
watzlawick	watzlawick
kolakowski	kolakowwski,kolakowski
millbrook	millbroook,millbrook
sacajawea	sacajawwea,sacajawea
koon	kooon,koon
trawls	trawwls,trawls
atlee	atlee
newsrooms	newsroooms,newsrooms
slowdowns	slowdowns
hornbook	hornboook,hornbook
creer	creer
jaap	jaap
irredeemably	irredeemably
vereeniging	vereeeniging,vereeniging
bleek	bleek
mcdowall	mcdowall
beechey	beeechey,beechey
bobrow	bobroww,bobrow
lebowitz	lebowwitz,lebowitz
cuddy	cudddy,cuddy
disowning	disowwning,disowning
offscreen	offscreen
hoofbeats	hooofbeats,hoofbeats
wilamowitz	wilamowitz
baade	baaade,baade
lowden	lowwden,lowden
laager	laaager,laager
eed	eeed,eed
floorboard	floorboard
gowda	gowwda,gowda
storybooks	storybooks
aabb	aaabb,aabb
mentee	menteee,mentee
quiddity	quidddity,quiddity
pinwheel	pinwheeel,pinwheel
fludd	fludd
adductors	adductors
greenschist	greenschist
squeegee	squeegee
lookups	loookups,lookups
pawl	pawwl,pawl
countee	counteee,countee
luddites	ludddites,luddites
oooooooo	oooooooooooo,oooooooo
cameroonian	camerooonian,cameroonian
bybee	bybeee,bybee
daan	daaan,daan
speedwell	speedwell
inwood	inwood
gowing	gowwing,gowing
mowgli	mowwgli,mowgli
lowness	lowwness,lowness
intraarterial	intraarterial
dhow	dhow
downfield	dowwnfield,downfield
sketchbooks	sketchbooks
giveaways	giveaways
saale	saaale,saale
doctorow	doctoroww,doctorow
pooley	poooley,pooley
peoplehood	peoplehoood,peoplehood
mook	moook,mook
keddie	kedddie,keddie
teepee	teeepeee,teepee
wahoo	wahoo
outgrowing	outgrowwing,outgrowing
bollywood	bollywood
fdd	fdd
colebrooke	colebroooke,colebrooke
exmoor	exmoor
queerly	queeerly,queerly
garnishee	garnisheee,garnishee
feedlots	feedlots
bawden	bawwden,bawden
woodcutters	woodcutters
steevens	steevens
lebow	leboww,lebow
towpath	towwpath,towpath
mawkish	mawwkish,mawkish
freebsd	freebsd
sraddha	sraddha
roon	rooon,roon
treetop	treeetop,treetop
unlikelihood	unlikelihood
cariboo	caribooo,cariboo
glowingly	glowingly
paratroop	paratrooop,paratroop
woodlot	woodlot
leese	leeese,leese
heddle	hedddle,heddle
tumbledown	tumbledowwn,tumbledown
downsize	dowwnsize,downsize
tralee	traleee,tralee
marilee	marileee,marilee
greengrocer	greengrocer
sweetbreads	sweetbreads
peening	peeening,peening
freeform	freeform
shantytown	shantytown
oddness	oddness
leaa	leaaa,leaa
knoop	knoop
downpours	dowwnpours,downpours
depauw	depauww,depauw
bhoodan	bhoodan
braddon	braddon
shantytowns	shantytowns
weeden	weeden
broadsheets	broadsheets
peeks	peeeks,peeks
freethinking	freethinking
waterwheel	waterwheel
macaws	macawws,macaws
logwood	logwood
coombes	cooombes,coombes
bengalee	bengaleee,bengalee
nightgowns	nightgowwns,nightgowns
keepsakes	keeepsakes,keepsakes
brownstein	brownstein
zook	zook
woodsmen	woodsmen
seebeck	seeebeck,seebeck
brainpower	brainpower
interbreed	interbreed
dershowitz	dershowwitz,dershowitz
lowlevel	lowwlevel,lowlevel
doddridge	dodddridge,doddridge
wallflower	wallflower
blowup	blowup
woozy	woozy
payees	payeees,payees
fleeced	fleeced
hurstwood	hurstwood
lowcountry	lowwcountry,lowcountry
landseer	landseeer,landseer
overthrows	overthrows
crossflow	crossflow
umpteenth	umpteenth
dombrowski	dombrowwski,dombrowski
nees	neees,nees
usaaf	usaaf
overfeeding	overfeeding
shallowest	shallowest
mckeever	mckeever
screenshot	screenshot
downwardly	dowwnwardly,downwardly
rowboats	rowwboats,rowboats
sugawara	sugawwara,sugawara
flowerbeds	flowerbeds
mccown	mccown
spooling	spooling
heeds	heeeds,heeds
cowgill	cowwgill,cowgill
seafoods	seafooods,seafoods
prithee	prithee
fraassen	fraassen
usee	usee
deegan	deeegan,deegan
moonbeams	mooonbeams,moonbeams
woolgar	woolgar
vreeland	vreeland
fellowman	fellowman
showbiz	showbiz
watchtowers	watchtowers
woodcraft	woodcraft
pillowcases	pillowwcases,pillowcases
barnouw	barnouww,barnouw
tawi	tawwi,tawi
cawing	cawwing,cawing
broadmoor	broadmoor
livingroom	livingrooom,livingroom
woodlots	woodlots
inbetween	inbetween
jawline	jawline
hounslow	hounsloww,hounslow
howth	howwth,howth
rowdies	rowwdies,rowdies
lowth	lowwth,lowth
clooney	clooney
staterooms	staterooms
lawrenceville	lawwrenceville,lawrenceville
floodwater	floodwater
gooders	goooders,gooders
esteems	esteems
awfulness	awfulness
woodring	woodring
powis	powwis,powis
macgowan	macgowwan,macgowan
goree	goreee,goree
nosebleed	nosebleeed,nosebleed
lydda	lyddda,lydda
rawat	rawwat,rawat
invitee	invitee
breedlove	breedlove
uncrowded	uncrowded
kaa	kaaa,kaa
bawd	bawwd,bawd
commandeer	commandeeer,commandeer
waterpower	waterpower
goold	gooold,goold
studding	studding
harrowed	harrowwed,harrowed
doormen	dooormen,doormen
goodby	gooodby,goodby
disagreeably	disagreeeably,disagreeably
queequeg	queeequeg,queequeg
billowy	billowwy,billowy
gnaws	gnaws
warshaw	warshaw
sleepwalker	sleepwalker
koos	kooos,koos
aways	aways
lowbrow	lowwbroww,lowbrow
weepy	weepy
nosebleeds	nosebleeeds,nosebleeds
yoknapatawpha	yoknapatawwpha,yoknapatawpha
crowninshield	crowninshield
adducted	adducted
wenatchee	wenatchee
mclaws	mclaws
escapee	escapee
overcooked	overcooked
gowers	gowwers,gowers
steeling	steeling
emcee	emcee
rookeries	roookeries,rookeries
ondaatje	ondaatje
pelee	peleee,pelee
flowerpot	flowerpot
frawley	frawley
disavows	disavowws,disavows
pillowed	pillowwed,pillowed
coots	cooots,coots
yellowtail	yellowwtail,yellowtail
dafydd	dafyddd,dafydd
quickdraw	quickdraww,quickdraw
boleslaw	boleslaww,boleslaw
satow	satoww,satow
condoleezza	condoleeezza,condoleezza
gree	gree
owerri	owerri
additively	additively
speechwriter	speechwriter
gowen	gowwen,gowen
expellees	expellees
mediterranee	mediterraneee,mediterranee
cookhouse	coookhouse,cookhouse
westergaard	westergaard
toolkits	tooolkits,toolkits
middlebrow	midddlebroww,middlebrow
retook	retoook,retook
meadowlark	meadowwlark,meadowlark
treed	treeed,treed
gees	geees,gees
barbee	barbeee,barbee
guffaws	guffawws,guffaws
fawzi	fawzi
hartlepool	hartlepoool,hartlepool
sambrook	sambroook,sambrook
preempting	preempting
macfadden	macfaddden,macfadden
boardrooms	boardroooms,boardrooms
streeten	streeten
arrestees	arrestees
parmelee	parmeleee,parmelee
kurnool	kurnoool,kurnool
potchefstroom	potchefstrooom,potchefstroom
staates	staates
booing	boooing,booing
powdering	powwdering,powdering
croon	croon
aiee	aieee,aiee
lagoonal	lagooonal,lagoonal
fishhook	fishhook
jackdaw	jackdaw
oolite	ooolite,oolite
ovenproof	ovenproof
pricewaterhousecoopers	pricewaterhousecoopers
eesti	eeesti,eesti
creedal	creedal
crestwood	crestwood
woodsworth	woodsworth
gawaine	gawwaine,gawaine
lawlike	lawwlike,lawlike
stowaway	stowaway
dowie	dowwie,dowie
servanthood	servanthoood,servanthood
addend	addend
brooked	brooked
sree	sree
longbow	longboww,longbow
priesthoods	priesthoods
lown	lowwn,lown
wheedle	wheedle
downplays	dowwnplays,downplays
lovaas	lovaaas,lovaas
ownerships	ownerships
biddulph	bidddulph,biddulph
comparee	compareee,comparee
areawide	areawide
daws	dawws,daws
shawna	shawna
masood	masoood,masood
steepening	steepening
monsoonal	monsooonal,monsoonal
coffeemaker	coffeeemaker,coffeemaker
zoogeography	zoogeography
killeen	killeeen,killeen
peevishly	peeevishly,peevishly
godown	godowwn,godown
eep	eeep,eep
nowlan	nowwlan,nowlan
cawdor	cawwdor,cawdor
farrowing	farrowing
spooler	spooler
beeton	beeeton,beeton
hoosiers	hooosiers,hoosiers
badawi	badawwi,badawi
whitlow	whitlow
kankakee	kankakeee,kankakee
preemployment	preemployment
shaheen	shaheen
cockatoos	cockatooos,cockatoos
honeymooners	honeymoooners,honeymooners
faw	faw
teel	teeel,teel
scarecrows	scarecrows
inflowing	inflowing
washrooms	washrooms
hawken	hawwken,hawken
roop	rooop,roop
dooryard	doooryard,dooryard
rauwolfia	rauwwolfia,rauwolfia
lowenfeld	lowwenfeld,lowenfeld
sweetman	sweetman
meetin	meeetin,meetin
cahoots	cahooots,cahoots
cartooning	cartoooning,cartooning
tillamook	tillamoook,tillamook
addicting	addicting
rajneesh	rajneeesh,rajneesh
drood	drood
unhallowed	unhallowed
cowpeas	cowwpeas,cowpeas
seeme	seeeme,seeme
neere	neeere,neere
bluegreen	bluegreen
alauddin	alauddin
feeley	feeley
careering	careeering,careering
musketeer	musketeeer,musketeer
snowcapped	snowcapped
beeman	beeeman,beeman
siddiqi	sidddiqi,siddiqi
mussoorie	mussooorie,mussoorie
teddington	tedddington,teddington
oooooo	ooooooooo,oooooo
sacagawea	sacagawwea,sacagawea
kalgoorlie	kalgooorlie,kalgoorlie
beechwood	beeechwood,beechwood
reenacting	reeenacting,reenacting
soone	sooone,soone
cartwheels	cartwheeels,cartwheels
awav	awav
reefed	reeefed,reefed
gidding	gidding
huw	huww,huw
buddhaghosa	budddhaghosa,buddhaghosa
ballyhoo	ballyhooo,ballyhoo
droops	droops
snowdrift	snowdrift
fishbowl	fishbowl
hiddenness	hidddenness,hiddenness
howto	howwto,howto
iow	ioww,iow
pooch	poooch,pooch
sheeler	sheeler
feely	feely
aage	aaage,aage
choosers	chooosers,choosers
dhows	dhows
kingswood	kingswood
screener	screener
cheeseman	cheeeseman,cheeseman
betweene	betweene
woolfs	woolfs
streeck	streeck
cowman	cowwman,cowman
cheroot	cherooot,cheroot
aee	aeee,aee
keepin	keeepin,keepin
footballs	footballs
sydow	sydoww,sydow
woolfolk	woolfolk
lithgow	lithgoww,lithgow
khaddar	khadddar,khaddar
cesspools	cesspoools,cesspools
colebrook	colebroook,colebrook
luddite	ludddite,luddite
cowshed	cowwshed,cowshed
durfee	durfeee,durfee
haack	haaack,haack
saddening	sadddening,saddening
coosa	cooosa,coosa
siddhas	sidddhas,siddhas
careerism	careeerism,careerism
boscawen	boscawwen,boscawen
saarland	saaarland,saarland
glendower	glendower
allpowerful	allpowerful
beeston	beeeston,beeston
browbeat	browbeat
sixteenths	sixteeenths,sixteenths
estabrook	estabrook
bookbinders	boookbinders,bookbinders
mooning	moooning,mooning
veeck	veeeck,veeck
cuddapah	cudddapah,cuddapah
afterschool	afterschool
wheezes	wheezes
caplow	caploww,caplow
bootable	boootable,bootable
