// English words that need whitelist for auto-restore
// Format: word → actual_output (what engine produced)
// Total: 2936 words

of → ò
is → í
as → á
was → ứa
this → thí
or → ỏ
his → hí
her → hẻ
has → há
there → thể
if → ì
been → bên
these → thế
its → ít
most → mót
did → đi
how → hơ
now → nơ
must → mút
own → ơn
us → ú
down → dơn
here → hể
power → pởe
thus → thú
war → ửa
off → of
last → lát
best → bét
seen → sên
days → dáy
terms → tém
major → mảo
sense → sến
low → lơ
room → rôm
air → ải
term → tẻm
past → pát
cost → cót
test → tét
seems → sếm
lower → lởe
basis → bái
turn → tủn
nor → nỏ
six → sĩ
soon → sôn
says → sáy
tax → tã
poor → pổ
lost → lót
town → tơn
seem → sêm
door → dổ
rest → rét
list → lít
yes → yé
costs → cót
ask → ák
post → pót
laws → lắ
meet → mêt
chief → chiè
sir → sỉ
der → dẻ
born → bỏn
box → bõ
car → cả
des → dé
paris → pái
died → đie
sex → sẽ
gas → gá
arms → ám
hair → hải
powers → pớe
tree → trê
trust → trút
mary → mảy
tests → tét
piece → piêc
trees → trế
referred → rered
choose → chốe
career → carer
les → lé
arm → ảm
bar → bả
mission → mision
coast → coát
lies → lié
corresponding → coresponding
sets → sét
troops → trốp
los → ló
pieces → piếc
queen → quên
carrying → carying
territory → teritory
mere → mể
chair → chải
root → rôt
won → ươn
cast → cát
sons → són
narrative → narative
vast → vát
host → hót
theme → thêm
row → rơ
lee → lê
vary → vảy
rooms → rốm
arrangement → arangement
moon → môn
turns → tún
towns → tớn
roots → rốt
poems → poém
usa → úa
ex → ẽ
chest → chét
correlation → corelation
surrounding → surounding
lips → líp
trans → trán
runs → rún
honor → hổn
cars → cá
moscow → mớc
songs → sóng
lists → lít
missing → mising
bus → bú
virus → víu
loans → loán
worst → ướt
dust → dút
busy → buý
doors → dố
hero → hẻo
roof → rồ
wars → ứa
terrible → terible
lesson → leson
loose → lốe
loop → lôp
est → ét
das → dá
corn → cỏn
harm → hảm
res → ré
lowest → lơét
max → mã
deeper → ddeeper
mix → mĩ
tons → tón
dans → dán
guns → gún
maps → máp
dad → đa
tower → tởe
pairs → pái
themes → thếm
arrive → arive
es → é
bias → bía
marx → mã
ties → tié
norms → nóm
referring → rering
phys → phý
thee → thê
moore → mổe
senses → sến
worn → ưởn
sur → sủ
lots → lót
beer → bể
refuse → rếu
bars → bá
poets → poét
rays → ráy
las → lá
lens → lén
guests → guét
er → ẻ
keeps → kếp
harris → haris
ix → ĩ
missed → mised
bits → bít
rats → rát
mississippi → misissippi
boats → boát
dawn → dăn
para → pẩ
thereof → thềo
susan → suán
morris → moris
irrigation → irigation
burst → bút
bow → bơ
corruption → coruption
guest → guét
rows → rớ
correction → corection
buyer → buyẻ
tries → trié
missouri → misouri
burn → bủn
cuts → cút
missionary → misionary
peer → pể
pierre → piere
chiefs → chié
dissolved → disolved
dense → dến
pays → páy
ussr → usr
guys → guý
horn → hỏn
refugees → refuges
quest → quét
meets → mết
missions → misions
sins → sín
deer → dể
dies → dié
ist → ít
trips → tríp
chaos → cháo
chairs → chái
cow → cơ
burns → bún
torn → tỏn
dissertation → disertation
tips → típ
peers → pế
hans → hán
deeds → đế
hers → hé
norm → nỏm
vis → ví
rests → rét
missionaries → misionaries
disc → díc
lungs → lúng
tense → tến
norway → nơảy
nest → nét
arriving → ariving
deed → đê
keen → kên
cups → cúp
beef → bề
donor → dổn
noon → nôn
boots → bốt
laura → lẩu
dissolution → disolution
ar → ả
quasi → quái
sums → súm
boom → bôm
dos → dó
cats → cát
trustees → trustes
mama → mâm
ins → ín
charm → chảm
ieee → iee
resurrection → reurection
ref → rè
auf → àu
owe → ơe
buyers → buyé
os → ó
gary → gảy
dis → dí
photos → phốt
aa → â
sits → sít
daddy → dady
borrowing → borowing
cows → cớ
gaps → gáp
ir → ỉ
barrel → barel
lest → lét
mar → mả
ass → as
owen → ơen
hosts → hót
doorway → dơảy
missile → misile
guarantees → guarantes
wax → ữa
nuts → nút
exert → ểt
mars → má
barn → bản
horrible → horible
corrosion → corosion
towers → tớe
bis → bí
ser → sẻ
lets → lét
ups → úp
chips → chíp
aus → áu
wa → ưa
lawn → lăn
chooses → chốe
cox → cõ
nos → nó
refuses → rếu
trusts → trút
cues → cué
aux → ãu
irs → í
bee → bê
missiles → misiles
poorer → pổe
boot → bôt
diana → diân
irradiation → iradiation
var → vả
tops → tóp
loops → lốp
lenses → lến
sara → sẩ
luis → lúi
hits → hít
congo → công
quarrel → quarel
recession → recsion
owns → ớn
harassment → harasment
dissolve → disolve
mist → mít
deferred → dered
tor → tỏ
cor → cỏ
taxi → tãi
guru → gủu
irrespective → irespective
tis → tí
horns → hón
tens → tén
bees → bế
dissatisfaction → disatisfaction
imf → ìm
irritation → iritation
nasa → nấ
rosa → roá
choir → chỏi
hips → híp
dissent → disent
password → pasword
lust → lút
reef → rề
donors → dốn
hats → hát
ses → sé
wu → ưu
gown → gơn
af → à
howe → hơe
erroneous → eroneous
ana → ân
coats → coát
diarrhea → diarhea
thirst → thít
diets → diét
dots → dót
worms → ướm
hawk → hăk
traps → tráp
dissociation → disociation
sofa → soà
mais → mái
esp → ép
referral → reral
arranging → aranging
terrified → terified
caps → cáp
worm → ưởm
barren → baren
dissemination → disemination
thief → thiè
xix → xĩ
goats → goát
bury → buỷ
hairs → hái
troop → trôp
myers → myé
nets → nét
queer → quể
mast → mát
boost → bốt
corrective → corective
ngos → ngó
cans → cán
oo → ô
owes → ớe
conf → còn
teen → tên
teens → tến
lays → láy
como → côm
honors → hốn
tier → tiẻ
cosmos → cốm
roofs → rố
roar → roả
keeper → kkeeper
sans → sán
cas → cá
sworn → sưởn
homo → hôm
marrying → marying
pest → pét
eec → êc
lasts → lát
tar → tả
mis → mí
ox → õ
worrying → ưorying
goose → gốe
correcting → corecting
pier → piẻ
chess → ches
dissatisfied → disatisfied
passport → pasport
buys → buý
dissection → disection
irreversible → ireversible
cos → có
nuns → nún
casts → cát
carr → car
hast → hát
cheer → chể
derrida → derida
nests → nét
aura → ẩu
dwarf → dừa
toast → toát
apr → ảp
queens → quến
downs → dớn
cops → cóp
raja → rậ
dams → dám
nur → nủ
hist → hít
correctness → corectness
rama → râm
yr → ỷ
poorest → pôét
char → chả
dir → dỉ
gangs → gáng
ere → ể
ax → ã
irresistible → iresistible
dues → dué
narration → naration
huts → hút
dissenting → disenting
rust → rút
wm → ưm
dana → dân
coasts → coát
boast → boát
wo → ươ
narrowing → narowing
mw → mư
doom → dôm
ee → ê
norris → noris
bursts → bút
rex → rẽ
bust → bút
niece → niêc
dyes → dyé
surf → sù
sw → sư
rene → rên
ef → è
terrifying → terifying
nw → nư
hangs → háng
bois → bói
ans → án
dar → dả
discs → díc
dow → dơ
vow → vơ
ter → tẻ
roast → roát
nora → noả
herr → her
wt → ưt
mas → má
casa → cấ
bows → bớ
www → ww
orissa → oisa
kerr → ker
urn → ủn
aj → ạ
dissipation → disipation
disseminated → diseminated
turf → tù
mir → mỉ
sown → sơn
oj → ọ
dee → dê
charms → chám
vows → vớ
gujarat → guẩt
dist → dít
boris → bói
irresponsible → iresponsible
laos → láo
dessert → desert
raj → rạ
poisson → poison
pasta → pất
oats → oát
thorn → thỏn
chef → chè
herring → hering
doris → dói
ther → thẻ
quart → quảt
dissimilar → disimilar
sow → sơ
ester → ểt
wong → ương
recess → recs
bats → bát
lor → lỏ
bowen → bơen
offs → ofs
lois → lói
loom → lôm
sus → sú
ooo → oo
gis → gí
cons → cón
piers → pié
horrified → horified
majors → máo
loaf → loà
vest → vét
burr → bur
pius → píu
tow → tơ
dd → đ
reefs → rế
vor → vỏ
misses → mises
reuse → rếu
ras → rá
unwillingness → unillingnes
lama → lâm
recessive → recsive
pesos → péo
dissipated → disipated
moor → mổ
ur → ủ
mats → mát
bays → báy
deem → dêm
esse → ese
lowe → lơe
asa → ấ
diese → diế
liar → lỉa
deduce → đêuc
wc → ưc
lowers → lớe
exeter → ểt
barr → bar
rowe → rơe
paso → páo
irritating → iritating
mer → mẻ
esters → ết
sachs → sách
gaas → gấ
dora → doả
dissolving → disolving
monsoon → monson
boon → bôn
moose → mốe
hirsch → hích
owens → ơén
carrot → carot
ber → bẻ
een → ên
mono → môn
cheers → chế
sas → sá
trays → tráy
taxa → tẫ
cw → cư
torres → tores
mus → mú
dodd → dod
bas → bá
guts → gút
aussi → ausi
asp → áp
keepers → kkeepers
gus → gú
nero → nẻo
nee → nê
tara → tẩ
hurrying → hurying
inf → ìn
dissonance → disonance
aaa → aa
referrals → rerals
pharisees → pharises
thorax → thoã
chaps → cháp
moran → moản
muir → mủi
looms → lốm
dieser → diể
moors → mố
ver → vẻ
irritable → iritable
parrot → parot
loosen → lôén
ws → ứ
beech → bêch
hawks → hắk
dyed → đye
unwarranted → unaranted
afar → ẩ
arresting → aresting
dissenters → disenters
arrhythmias → arhythmias
mos → mó
beet → bêt
swarm → sưảm
raf → rà
oasis → oái
sis → sí
rossi → rosi
dyer → dyẻ
thorns → thón
bern → bẻn
russo → ruso
yer → yẻ
ddt → đt
hens → hén
tres → tré
err → er
dissolves → disolves
cary → cảy
lax → lã
lex → lẽ
hays → háy
lerner → lển
taps → táp
boar → boả
kits → kít
def → dè
hermes → hếm
chests → chét
lawns → lắn
beers → bế
pies → pié
testes → tết
ama → âm
vers → vé
terre → tere
rees → rế
har → hả
lis → lí
veneer → vener
ems → ém
barring → baring
guerre → guere
bowers → bớe
nana → nân
bower → bởe
sar → sả
hier → hiẻ
irreducible → ireducible
trojan → troạn
corrosive → corosive
rw → rư
canaan → canan
warring → uaring
gasp → gáp
boasts → boát
trois → trói
bur → bủ
voor → vổ
haas → hấ
barns → bán
horrid → horid
airs → ái
dissected → disected
tiers → tié
gums → gúm
ars → á
kern → kẻn
seer → ser
dod → đo
berne → bển
mes → mé
gays → gáy
musee → múee
ej → ẹ
sono → sôn
irrevocable → irevocable
bets → bét
woo → uô
dissident → disident
dw → dư
chow → chơ
xerox → xẽo
dissociated → disociated
quran → quản
hesse → hese
noir → nỏi
recesses → recses
masse → mase
uns → ún
hues → hué
hoop → hôp
gowns → gớn
cora → coả
duffy → dufy
vas → vá
liszt → lit
diarrhoea → diarhoea
passports → pasports
deems → dếm
ww → w
yrs → ý
misc → míc
powerlessness → powerlesness
oars → oá
soot → sôt
dost → dót
ism → ím
sox → sõ
iff → if
tris → trí
dura → dủa
huron → huỏn
rowan → rơan
harms → hám
ers → é
mara → mẩ
nas → ná
passwords → paswords
pero → pẻo
turret → turet
serfs → sé
moons → mốn
dix → dĩ
refs → ré
bor → bỏ
wr → ử
disseminate → diseminate
bosch → bóch
chasm → chám
resurrected → reurected
voir → vỏi
twas → tứa
mori → mỏi
dissidents → disidents
assn → asn
tex → tẽ
pere → pể
barron → baron
wp → ưp
irreconcilable → ireconcilable
vos → vó
sens → sén
dissension → disension
bins → bín
cowan → cơan
corral → coral
hee → hê
soar → soả
gist → gít
boers → boé
issn → isn
liens → lién
ics → íc
orr → or
ij → ị
boas → boá
meme → mêm
hurst → hút
gower → gởe
taxis → tái
rosary → roảy
correlative → corelative
docs → dóc
kessler → kesler
kraus → kráu
hops → hóp
dips → díp
dwarfs → dứa
pow → pơ
surrendering → surendering
loo → lô
ecr → ẻc
masts → mát
loot → lôt
mists → mít
durand → đuản
heme → hêm
uf → ù
pharm → phảm
ara → ẩ
eps → ép
hari → hải
ganga → gâng
masson → mason
curr → cur
exec → ễc
desserts → deserts
tins → tín
sorrowful → sorowful
oar → oả
quark → quảk
ons → ón
wort → ưởt
boo → bô
doorways → dơáy
bene → bên
pw → pư
moot → môt
pawn → păn
acs → ác
dada → đâ
dissertations → disertations
emf → èm
rams → rám
sys → sý
wj → ự
denser → dển
barre → bare
dissipate → disipate
lori → lỏi
causa → cấu
ow → ơ
mora → moả
mari → mải
ops → óp
truer → truẻ
musa → múa
rana → rân
chops → chóp
suis → súi
renee → rene
usc → úc
baja → bậ
isp → íp
soaps → soáp
gust → gút
lara → lẩ
longs → lóng
hoof → hồ
mens → mén
torr → tor
irreparable → ireparable
saffron → safron
gw → gư
beets → bết
waterproof → waterprof
oas → oá
norwood → norwod
lars → lá
ams → ám
parma → pẩm
swans → sưán
cusp → cúp
hausa → hấu
hosp → hóp
leech → lêch
mor → mỏ
theseus → thếu
peso → péo
vans → ván
lees → lế
oro → ổ
nara → nẩ
mirroring → miroring
busch → búch
horst → hót
mays → máy
trieste → triết
wk → ưk
thor → thỏ
ies → ié
pari → pải
gar → gả
mans → mán
hex → hẽ
suns → sún
trier → triẻ
tw → tư
qos → qó
coop → côp
vere → vể
dissuade → disuade
posse → pose
exxon → exon
lisp → líp
ifn → ìn
bw → bư
swarms → sưám
torre → tore
aix → ãi
curran → curan
hereof → hềo
saws → sắ
estes → ết
derrick → derick
lawlessness → lawlesness
cherokees → cherokes
dif → dì
caro → cảo
tenses → tến
disseminating → diseminating
lamar → lẩm
bari → bải
dude → đue
chakra → chẩk
dissecting → disecting
sacs → sác
cara → cẩ
vero → vẻo
ajax → ẫ
cocoon → cocon
horrifying → horifying
bono → bôn
pyrenees → pyrenes
ips → íp
harrowing → harowing
booze → boe
dissociate → disociate
dieses → diế
corrupting → corupting
esr → ẻ
ree → rê
caso → cáo
taos → táo
tes → té
dorm → dỏm
esc → éc
laps → láp
rasa → rấ
hasta → hất
tern → tẻn
dissociative → disociative
reps → rép
recessed → recsed
syst → sýt
morn → mỏn
surat → suảt
lux → lũ
vir → vỉ
mons → món
ias → ía
ros → ró
coo → cô
passe → pase
didst → đít
cur → củ
chiapas → chíâp
chefs → ché
coon → côn
seers → sế
perrin → perin
bos → bó
sos → só
nis → ní
moro → mổ
arrhythmia → arhythmia
tarn → tản
parr → par
kris → krí
samaj → sậm
rosario → rôải
ast → át
narrowness → narowness
loco → lôc
lans → lán
rus → rú
purana → puẩn
dens → dén
deferral → deral
bir → bỉ
correlating → corelating
disagrees → disagres
gonorrhea → gonorhea
mana → mân
truest → truét
booms → bốm
bans → bán
dower → dởe
diesem → diếm
swaps → sưáp
roost → rốt
hoax → hoã
mins → mín
corroboration → coroboration
lows → lớ
aps → áp
epr → ẻp
nurs → nú
choirs → chói
hangar → hẩng
puree → pủee
hoops → hốp
noose → nốe
gif → gì
mee → mê
wf → ừ
garret → garet
sari → sải
beseech → besech
merriment → meriment
hors → hó
nox → nõ
lys → lý
ifs → í
uaw → ưa
hoofs → hố
mow → mơ
porn → pỏn
dais → dái
ono → ôn
tas → tá
asshole → ashole
mower → mởe
taro → tảo
sor → sỏ
ys → ý
ims → ím
desde → đế
hara → hẩ
lair → lải
cosa → coá
gaap → gâp
ets → ét
vw → vư
bums → búm
twa → tưa
horrendous → horendous
anwar → ẩn
lar → lả
looser → lổe
ddr → đr
tongs → tóng
liars → lía
burrowing → burowing
bangs → báng
verne → vển
nieces → niếc
hw → hư
quirk → quỉk
coax → coã
aas → ấ
asm → ám
usaf → ùa
resp → rép
ens → én
herrmann → hermann
tics → tíc
moms → móm
lynx → lỹn
derry → dery
recessions → recsions
dias → día
eos → éo
busts → bút
dwyer → dưyẻ
hos → hó
serf → sè
ecj → ẹc
darn → dản
meer → mể
vests → vét
tessa → tesa
aan → ân
ajar → ẩ
coco → côc
thorac → thoảc
dido → đio
heen → hên
marr → mar
lana → lân
dissimilarity → disimilarity
mies → mié
hirst → hít
doran → doản
urns → ún
loon → lôn
puffy → pufy
lusaka → luấk
huns → hún
lw → lư
moans → moán
wn → ưn
canaanite → cananite
tasso → taso
massa → masa
tamar → tẩm
sows → sớ
cher → chẻ
gama → gâm
rojas → roá
perm → pẻm
dissented → disented
loro → lổ
ese → ế
hoo → hô
corr → cor
kee → kê
narrating → narating
congr → cỏng
irr → ir
rostow → rớt
gusts → gút
dissect → disect
cetera → ccetera
hassle → hasle
dade → đae
hamas → hấm
puranas → puấn
toro → tổ
suisse → suise
quits → quít
nots → nót
noaa → noâ
afm → àm
maj → mạ
taj → tạ
cusps → cúp
didn → đin
ost → ót
poco → pôc
tiene → tiên
twos → tướ
arf → à
nes → né
nair → nải
nussbaum → nusbaum
messrs → mesrs
dor → dỏ
ucs → úc
referees → referes
giraffe → giafe
diesen → diến
haji → hại
doo → dô
basu → báu
asst → ast
ker → kẻ
tori → tỏi
mots → mót
bier → biẻ
trojans → troán
duran → duản
mississippian → misissippian
irreplaceable → ireplaceable
lias → lía
tur → tủ
menses → mến
ner → nẻ
rajya → rậy
irrefutable → irefutable
otros → ốt
afr → ả
dorado → đoảo
veer → vể
puis → púi
uj → ụ
dorn → dỏn
gasps → gáp
arrhenius → arhenius
moo → mô
haus → háu
moray → moảy
exe → ễ
ust → út
ghee → ghê
chas → chá
churn → chủn
lusts → lút
ius → íu
mair → mải
caa → câ
quarrying → quarying
mex → mẽ
icj → ịc
sars → sá
dissonant → disonant
hus → hú
meso → méo
aca → âc
thar → thả
wwii → wii
sorrel → sorel
terns → tén
arras → aras
nasir → nải
amar → ẩm
buns → bún
quarreling → quareling
buffy → bufy
rungs → rúng
lif → lì
tues → tué
husayn → huáyn
roars → roá
roms → róm
bakr → bảk
saar → sar
iaa → iâ
tits → tít
puja → pụa
erring → ering
nics → níc
sura → sủa
sofas → soá
varna → vẩn
maris → mái
mets → mét
ooze → oe
sawn → săn
usp → úp
nama → nâm
dur → dủ
chir → chỉ
quarrelling → quarelling
vox → võ
dodds → đó
asch → ách
deferring → dering
ceteris → cceteris
lamas → lấm
affd → afd
usr → ủ
reste → rết
cots → cót
guesswork → gueswork
dons → dón
mesure → mểu
meuse → mếu
hurrah → hurah
asc → ác
nar → nả
bora → boả
hajj → haj
toms → tóm
vaux → vãu
erst → ét
mayr → mảy
chee → chê
esso → eso
terme → tểm
yee → yê
gans → gán
dissensions → disensions
hora → hoả
hoary → hoảy
naa → nâ
benes → bến
masai → mấi
dissolute → disolute
roos → rố
darren → daren
basso → baso
byers → byé
hams → hám
borax → boã
dusts → dút
loos → lố
thais → thái
vats → vát
mawr → mẳ
ais → ái
chats → chát
hor → hỏ
toasts → toát
dodson → đốn
ocr → ỏc
sama → sâm
aswan → ấn
sams → sám
vax → vã
theor → thẻo
defuse → dếu
doers → doé
cura → của
mois → mói
lasso → laso
uw → ư
iww → iw
darryl → daryl
mems → mém
maru → mảu
ris → rí
maas → mấ
vee → vê
hoot → hôt
hoar → hoả
ves → vé
uar → ủa
larsson → lason
poop → pôp
espresso → epso
ruts → rút
vasa → vấ
dissipative → disipative
duns → dún
ors → ó
arr → ar
sips → síp
dara → dẩ
thess → thes
ler → lẻ
sussman → susman
vermeer → vểm
tana → tân
cosmo → cốm
dissuaded → disuaded
aro → ảo
monogr → mổng
maura → mẩu
topos → tốp
rensselaer → renselaer
sirs → sí
tos → tó
ats → át
cwt → cưt
thos → thó
erm → ẻm
tof → tò
tees → tế
rosas → roá
marais → mấi
gosse → gose
ene → ên
ipr → ỉp
sues → sué
resurrect → reurect
wor → ưở
worthlessness → worthlesness
hir → hỉ
leer → lể
usn → ún
tyr → tỷ
cams → cám
disservice → diservice
bowes → bớe
mof → mò
misspelled → mispelled
amr → ảm
hana → hân
baa → bâ
mossbauer → mosbauer
murat → muảt
aram → ẩm
ries → rié
dessen → desen
missus → misus
bij → bị
gur → gủ
ospf → òp
rer → rẻ
trams → trám
ocs → óc
varus → váu
wot → ươt
dari → dải
dawns → dắn
varma → vẩm
missoula → misoula
thieme → thiêm
bask → bák
neues → nếu
aiaa → aia
nir → nỉ
hof → hò
dads → đá
harrod → harod
durst → dút
manas → mấn
tors → tó
vara → vẩ
lasswell → laswell
naps → náp
cocoons → cocons
quests → quét
ipx → ĩp
dowd → đơ
surreptitious → sureptitious
roo → rô
hur → hủ
hons → hón
vern → vẻn
misshapen → mishapen
voix → või
cana → cân
howes → hớe
eof → èo
norsk → nók
enrollees → enrolles
ajr → ả
barrenness → barenness
arraignment → araignment
secs → séc
sais → sái
isps → íp
naca → nâc
dijk → dịk
lors → ló
irrigating → irigating
quasars → quấ
errol → erol
nist → nít
peruse → pếu
conor → cổn
nuer → nuẻ
goers → goé
bast → bát
vaca → vâc
lessees → lesses
poore → pổe
quis → quí
chins → chín
myrrh → myrh
bajo → bạo
ochs → óch
chakras → chấk
pues → pué
phasor → phảo
bara → bẩ
wwf → wf
dde → đe
gooch → gôch
asr → ả
tus → tú
termes → tếm
soars → soá
thurs → thú
ques → qué
dissimulation → disimulation
thiers → thié
nasr → nả
ecs → éc
vari → vải
itr → ỉt
atr → ảt
dado → đao
irreligious → ireligious
susa → súa
transsexual → transexual
persson → peson
canaanites → cananites
isr → ỉ
maa → mâ
marriageable → mariageable
ier → iẻ
gats → gát
dissipating → disipating
dessus → desus
rips → ríp
conferees → conferes
meerut → mểut
risc → ríc
monro → mổn
nowak → nơak
kirsch → kích
marys → máy
saps → sáp
neuer → nểu
saf → sà
anas → ấn
macs → mác
mur → mủ
moos → mố
icr → ỉc
rosso → roso
hoffa → hofa
baur → bảu
dodo → đô
hes → hé
vier → viẻ
echr → ẻch
seeps → sếp
duets → duét
pierrot → pierot
carre → care
boars → boá
hassles → hasles
manga → mâng
enfeebled → enfebled
basse → base
dissections → disections
woof → uồ
ece → êc
pensee → pense
hafiz → hai
heer → hể
dissenter → disenter
bax → bã
cowen → cơen
parris → paris
isms → ím
corroborating → coroborating
charioteer → charioter
aac → âc
cosas → coá
dorr → dor
boosts → bốt
heures → hếu
russe → ruse
thongs → thóng
nomos → nốm
torrid → torid
missal → misal
choo → chô
kiefer → kiể
casi → cái
haar → hẩ
mayas → mấy
marissa → maisa
purring → puring
mesures → mếu
luxor → luỏ
fddi → fđi
myer → myẻ
nies → nié
dissipates → disipates
wesson → ueson
oops → ốp
raju → rạu
nix → nĩ
pasa → pấ
tapas → tấp
sosa → soá
ux → ũ
cwa → cưa
dissimilarities → disimilarities
pura → pủa
beseeching → beseching
rasp → ráp
bes → bé
dex → dẽ
mura → mủa
longo → lông
armas → ấm
dere → dể
tomo → tôm
ecf → èc
naar → nẩ
aran → ẩn
dissociates → disociates
neusner → nểun
wormwood → wormwod
thana → thân
lossless → losless
swa → sưa
iee → iê
dorms → dóm
baca → bâc
pusan → puán
vex → vẽ
ddc → đc
neem → nêm
tir → tỉ
urs → ú
ters → té
soir → sỏi
tama → tâm
lacs → lác
herron → heron
asf → à
engrs → éng
lix → lĩ
quays → quáy
unworthiness → ửnothines
misstatement → mistatement
kips → kíp
nary → nảy
chessboard → chesboard
tener → tển
garrulous → garulous
derm → dẻm
ufa → ùa
dene → dên
wycliffe → uyclife
sower → sởe
haan → hân
xor → xỏ
soong → sông
duras → dúa
purr → pur
aos → áo
lasch → lách
missa → misa
dwt → dưt
vets → vét
sierras → sieras
masa → mấ
bef → bè
nast → nát
tamas → tấm
asn → án
isc → íc
atf → àt
missive → misive
perrot → perot
coram → coảm
bosco → bốc
rif → rì
viene → viên
choix → chõi
caisson → caison
inr → ỉn
dosed → đoé
barros → baros
doesn → doén
rots → rót
tojo → tộ
aarp → ẩp
giri → gỉi
taffy → tafy
menger → mểng
corns → cón
bers → bé
sana → sân
sarai → sẩi
gongs → góng
aja → ậ
tans → tán
becher → bểch
ietf → ièt
aaf → ầ
haj → hạ
mips → míp
examinees → examines
gos → gó
manx → mãn
hurons → huón
chiasm → chíam
nyssa → nysa
toot → tôt
kerner → kển
mosse → mose
yf → ỳ
dds → đs
casson → cason
ees → ế
monsoons → monsons
oxon → ỗn
cus → cú
truro → truỏ
sof → sò
lora → loả
asw → ắ
veneers → veners
transsexuals → transexuals
ror → rỏ
oop → ôp
darya → dẩy
arran → aran
darauf → dầu
saarc → sẩc
ern → ẻn
oeec → oêc
orm → ỏm
trw → trư
oooo → oô
maxi → mãi
messner → mesner
daro → dảo
noor → nổ
memes → mếm
gow → gơ
eez → e
ded → đe
tcdd → tcđ
rowers → rớe
khasi → khái
orf → ò
raps → ráp
warr → war
gora → goả
naf → nà
saks → sák
dda → đa
acr → ảc
aar → ẩ
corroborative → coroborative
mowers → mớe
mongoose → mongose
irretrievable → iretrievable
vies → vié
deeps → dếp
ucr → ủc
trims → trím
kharif → khài
nasi → nái
dartmoor → dartmor
coons → cốn
quire → quiẻ
buf → bù
gurr → gur
icf → ìc
dof → dò
hansson → hanson
mowrer → mởe
queste → quết
maf → mà
urry → ury
tussle → tusle
quern → quẻn
ots → ót
seme → sêm
tepee → tepe
kremer → krểm
samar → sẩm
ayr → ảy
ojo → ộ
issa → isa
heure → hểu
coffees → coffes
sejm → sẹm
sorrowing → sorowing
saris → sái
sisson → sison
taux → tãu
tanf → tàn
yj → ỵ
reuss → reus
acf → àc
essa → esa
gonorrhoeae → gonorhoeae
terr → ter
trist → trít
misstatements → mistatements
dasa → dấ
aur → ảu
terracing → teracing
aap → âp
teetering → tteetering
mesmer → mểm
mops → móp
tars → tá
byes → byé
dissents → disents
sarma → sẩm
goran → goản
quos → quó
pyrrhus → pyrhus
basf → bà
nys → ný
dyers → dyé
terrigenous → terigenous
mejor → mẻo
tary → tảy
aso → áo
ruf → rù
errs → ers
engr → ẻng
doon → dôn
tryst → trýt
onr → ỏn
lissa → lisa
posi → pói
rasch → rách
disp → díp
busse → buse
irremediable → iremediable
coir → cỏi
nayar → nẩy
cosi → cói
hwa → hưa
cust → cút
eeo → êo
ddd → dd
daf → dà
dissociating → disociating
ifr → ỉ
haa → hâ
ura → ủa
perron → peron
burrs → burs
quasar → quẩ
carrel → carel
ddl → đl
diener → diển
hori → hỏi
soaks → soák
dud → đu
moores → mốe
mown → mơn
nef → nè
afs → á
chums → chúm
dowden → đơen
rois → rói
uwe → ưe
veen → vên
sways → sưáy
pwm → pưm
dissidence → disidence
biens → bién
herrnstein → hernstein
sary → sảy
pense → pến
dowson → dốn
noirs → nói
isn → ín
chasms → chám
lef → lè
lus → lú
tarr → tar
boor → bổ
doj → dọ
ojos → ố
porno → pổn
eee → ee
dede → đê
escher → ểch
deen → dên
caf → cà
apj → ạp
orrin → orin
nawaz → na
marya → mẩy
fetes → ffetes
bysshe → byshe
ooooo → oo
bongo → bông
noo → nô
herrn → hern
astr → ảt
tora → toả
hama → hâm
roxas → roá
goon → gôn
aat → ât
veces → vếc
iaf → ìa
hefner → hển
aaas → as
verner → vển
noms → nóm
kronor → krổn
peet → pêt
hopf → hòp
naxos → náo
warranting → uaranting
pwa → pưa
thins → thín
dudes → đué
thes → thé
passband → pasband
coors → cố
haussmann → hausmann
hox → hõ
bufo → buò
dama → dâm
senge → sêng
horwood → horwod
dissatisfactions → disatisfactions
corruptible → coruptible
wsc → ức
loosens → lôén
murata → muẩt
kees → kế
taf → tà
lief → liè
trow → trơ
haps → háp
terrorizing → terorizing
loams → loám
arai → ẩi
guar → gủa
buxom → buõm
vocs → vóc
loran → loản
asap → ấp
coos → cố
gins → gín
usu → úu
offa → ofa
irm → ỉm
nus → nú
masao → mấo
unrra → unra
oxo → ỗ
penser → pển
rist → rít
gana → gân
lox → lõ
ranga → râng
mowat → mơat
tisza → tia
muons → muón
irreproachable → ireproachable
bons → bón
bana → bân
daud → đau
hangars → hấng
liana → liân
barres → bares
rais → rái
dword → đưở
dessau → desau
wwi → wi
twp → tưp
escapees → escapes
larissa → laisa
ussher → usher
omo → ôm
dax → dã
bist → bít
dissonances → disonances
massless → masless
rosch → róch
chasse → chase
amf → àm
hepes → hếp
comr → cỏm
wch → ưch
emr → ẻm
khans → khán
leche → lêch
roasts → roát
damas → dấm
teeter → tteeter
erf → è
bix → bĩ
dorrit → dorit
irri → iri
thats → thát
berner → bển
hansa → hấn
treks → trék
baas → bấ
powwow → powow
cocos → cốc
caja → cậ
rojo → rộ
coot → côt
asso → aso
dees → dế
rast → rát
mif → mì
siete → siêt
aws → ắ
ists → ít
rar → rả
lesse → lese
boxwood → boxwod
inj → ịn
berm → bẻm
maurras → mauras
phos → phó
moats → moát
cusa → cúa
mers → mé
susy → suý
hopwood → hopwod
syr → sỷ
barua → bẩu
ressources → resources
garo → gảo
peeters → ppeeters
cori → cỏi
usw → ứ
boro → bổ
garrod → garod
orn → ỏn
anf → àn
boos → bố
tdd → tđ
pyrrhotite → pyrhotite
maar → mẩ
irruption → iruption
lajos → láo
sere → sể
tene → tên
queers → quế
quips → quíp
deduces → đếuc
wks → ứk
duda → đua
tox → tõ
hums → húm
dux → dũ
moir → mỏi
serres → seres
wschr → ửch
diene → diên
susana → suấn
casus → cáu
rafi → rài
acrs → ác
esf → è
defused → đếu
burros → buros
veers → vế
diarrheal → diarheal
quas → quá
terres → teres
iar → ỉa
dest → dét
erster → ểt
rossby → rosby
domo → dôm
mors → mó
exner → ển
oozes → oé
toots → tốt
goons → gốn
berners → bến
hoots → hốt
wfp → ừp
transshipment → transhipment
seest → sết
caisse → caise
giorno → giổn
suf → sù
puisse → puise
disse → dise
perspex → pễp
swf → sừ
dori → dỏi
correctable → corectable
coxa → coã
nif → nì
duro → duỏ
gonorrhoea → gonorhoea
thurow → thuở
nene → nên
pemex → pễm
harrap → harap
parolees → paroles
passmore → pasmore
neces → nếc
ocho → ôch
beeper → bbeeper
naso → náo
resurrecting → reurecting
gor → gỏ
awt → ăt
buts → bút
okw → ơk
assholes → asholes
vars → vá
assignees → assignes
kir → kỉ
lorn → lỏn
kis → kí
qw → qư
pwr → pử
corroding → coroding
asaf → ầ
lems → lém
wasson → uason
carus → cáu
laisse → laise
vasc → vác
achr → ảch
oes → oé
oot → ôt
auras → ấu
pastas → pất
chary → chảy
afa → ầ
birren → biren
rijn → rịn
dus → dú
trots → trót
pensees → penses
loons → lốn
hows → hớ
tots → tót
bassa → basa
baru → bảu
coops → cốp
dissembling → disembling
hasse → hase
kronos → krốn
esch → éch
messe → mese
cower → cởe
mics → míc
cws → cứ
perret → peret
thir → thỉ
toon → tôn
tarai → tẩi
desc → déc
darf → dà
dafi → dài
ois → ói
tiere → tiể
tufa → tùa
maus → máu
cachar → cẩch
neer → nể
basta → bất
mosm → móm
pharma → phẩm
hooray → hôảy
pws → pứ
rara → rẩ
chooser → chổe
maja → mậ
corre → core
tows → tớ
voorhees → voorhes
disseminates → diseminates
pyrrhic → pyrhic
roams → roám
horan → hoản
rusts → rút
heros → héo
mims → mím
jeter → jjeter
erec → ểc
gowan → gơan
tanga → tâng
erne → ển
nasw → nắ
meps → mép
sats → sát
emer → ểm
tias → tía
pawnees → pawnes
longwood → longwod
burris → buris
lof → lò
hij → hị
arn → ản
menge → mêng
poon → pôn
teste → tết
ujjain → ujain
ues → ué
tims → tím
aif → ài
dienes → diến
coro → cổ
lotos → lốt
ddp → đp
deme → dêm
bary → bảy
oso → ố
ustr → ủt
iarc → ỉac
narr → nar
aau → âu
lowes → lớe
tierras → tieras
passwd → paswd
deferrals → derals
assr → asr
hassler → hasler
casos → cáo
recessionary → recsionary
rost → rót
aam → âm
myr → mỷ
tej → tẹ
dacha → dâch
oort → ổt
pacha → pâch
meech → mêch
roosts → rốt
teetered → tteetered
osc → óc
gast → gát
terras → teras
barret → baret
gaur → gảu
irresolution → iresolution
terris → teris
tosa → toá
owi → ơi
khurasan → khuấn
ansar → ẩn
misr → mỉ
tono → tôn
vwf → vừ
cwc → cưc
chars → chá
bowser → bởe
lusk → lúk
eet → êt
leet → lêt
rix → rĩ
vdd → vđ
lowi → lơi
mums → múm
uts → út
sops → sóp
laocoon → laocon
irradiating → iradiating
amax → ẫm
cwm → cưm
arawak → ẩk
ower → ởe
gyms → gým
tost → tót
herm → hẻm
gaf → gà
rescher → rểch
dessa → desa
verre → vere
suas → súa
carrol → carol
khas → khá
tyrrhenian → tyrhenian
rossman → rosman
vaso → váo
umw → ưm
dissemble → disemble
nips → níp
horas → hoá
nonfood → nonfod
guyer → guyẻ
ganja → gận
sws → sứ
sif → sì
comoros → cốm
harre → hare
bors → bó
bair → bải
wrst → ứt
swp → sưp
pharos → pháo
tosi → tói
nays → náy
lorsch → lóch
sexe → sễ
goof → gồ
pomo → pôm
sers → sé
meow → meơ
paar → pẩ
tura → tủa
passu → pasu
beeps → bếp
nono → nôn
offe → ofe
boons → bốn
wms → ứm
duds → đú
oms → óm
visscher → vischer
muro → muỏ
tif → tì
uas → úa
ders → dé
macaw → măc
rossa → rosa
nueces → nuếc
hys → hý
doxa → doã
barras → baras
irrecoverable → irecoverable
oom → ôm
vix → vĩ
haro → hảo
ests → ét
lujan → luạn
lier → liẻ
vips → víp
leeper → lleeper
aai → âi
truax → trũa
tisch → tích
marris → maris
misspelling → mispelling
dooms → dốm
transsexualism → transexualism
rowse → rớe
mier → miẻ
majus → máu
basi → bái
wx → ữ
missourians → misourians
cama → câm
peeps → pếp
quiere → quiể
misspellings → mispellings
dois → dói
oor → ổ
mux → mũ
cof → cò
dorf → dò
horm → hỏm
nissl → nisl
nwfp → nừp
teem → têm
nowe → nơe
basswood → baswood
nof → nò
qasr → qả
daa → dâ
pdd → pđ
aaai → aai
besson → beson
giese → giế
awk → ăk
chara → chẩ
veneered → venered
heeft → hềt
hest → hét
hooch → hôch
therm → thẻm
aaaa → aâ
bassi → basi
apf → àp
varnas → vấn
missis → misis
saxo → são
wissler → wisler
nuys → nuý
soja → soạ
eer → ể
aspx → ãp
unwarrantable → unarantable
bdd → bđ
sese → sế
curs → cú
asat → ất
mossi → mosi
recs → réc
ief → iè
churns → chún
vermes → vếm
khama → khâm
maat → mât
chiefest → chiết
ajc → ạc
mamas → mấm
tems → tém
mox → mõ
awacs → ấc
curwen → cưẻn
mansa → mấn
barna → bẩn
laa → lâ
vois → vói
chama → châm
safa → sầ
oon → ôn
herren → heren
imr → ỉm
lais → lái
metes → mết
amj → ạm
howse → hớe
usps → úp
danda → đân
tanah → tânh
carron → caron
chora → choả
chur → chủ
mortgagees → mortgages
roark → roảk
lese → lế
bots → bót
derricks → dericks
irredeemable → iredeemable
lowa → lơa
rosse → rose
larus → láu
posix → põi
nias → nía
puer → puẻ
esm → ém
oost → ốt
hese → hế
sasson → sason
nori → nỏi
eor → ẻo
wom → ươm
duos → duó
tux → tũ
gari → gải
herrschaft → herschaft
nats → nát
oaf → oà
langs → láng
raiffa → raifa
kreps → krép
hasa → hấ
nux → nũ
bere → bể
corms → cóm
roszak → roak
ansa → ấn
loris → lói
rans → rán
chere → chể
exerc → ểc
sachar → sẩch
lochs → lóch
rasta → rất
mdd → mđ
hiaa → hiâ
thur → thủ
pongo → pông
lir → lỉ
vana → vân
trias → tría
disproof → disprof
trost → trót
cari → cải
dessins → desins
borst → bót
misstep → mistep
daraus → dấu
usus → úu
durr → dur
etf → èt
duree → dủee
sauf → sàu
macha → mâch
swets → sưét
efs → é
kes → ké
saur → sảu
towson → tốn
boj → bọ
teems → tếm
gir → gỉ
haf → hà
lesch → léch
thaf → thà
etr → ẻt
eme → êm
khor → khỏ
cays → cáy
dissociations → disociations
raaf → rầ
mest → mét
wsp → ứp
sowers → sớe
garn → gản
theos → théo
basch → bách
iprs → íp
sacha → sâch
swoops → suốp
chaka → châk
masi → mái
passbook → pasbook
eres → ế
transferees → transferes
gierek → giểk
wop → ươp
nusa → núa
mississauga → misissauga
papas → pấp
cowpox → cỗp
chos → chó
techs → téch
dej → dẹ
borno → bổn
missense → misense
iasc → íac
hoon → hôn
kins → kín
missives → misives
vias → vía
porras → poras
saro → sảo
moana → moân
manatees → manates
quires → quié
cowes → cớe
darrel → darel
quar → quả
bosse → bose
pana → pân
ddi → đi
sori → sỏi
susskind → suskind
musees → muses
gara → gẩ
pene → pên
kerns → kén
nwp → nưp
maro → mảo
acas → ấc
harrah → harah
derriere → deriere
guerres → gueres
booz → bo
versts → vét
morais → moái
raa → râ
marwar → mẩ
awn → ăn
dowex → dỡe
worf → ườ
marring → maring
nits → nít
eure → ểu
tras → trá
soas → soá
sanga → sâng
euer → ểu
hooft → hồt
charring → charing
ossa → osa
khana → khân
eets → ết
masc → mác
chor → chỏ
burs → bú
irst → ít
ifrs → í
chari → chải
poof → pồ
efe → ề
dard → đả
itf → ìt
gaor → gảo
ofs → ó
wcs → ức
tari → tải
berns → bén
oaa → oâ
mene → mên
uart → uảt
vif → vì
dessous → desous
gams → gám
mississippians → misissippians
camas → cấm
thaws → thắ
mojo → mộ
duas → dúa
qur → qủ
charron → charon
mees → mế
uscs → úc
haart → hẩt
afsc → ác
birr → bir
beseeched → beseched
ressentiment → resentiment
demes → dếm
miers → mié
bori → bỏi
verres → veres
costo → cốt
turan → tuản
usk → úk
saif → sài
baro → bảo
tyree → tỷee
hasp → háp
peste → pết
nws → nứ
owa → ơa
ausstellung → austellung
dusan → duán
viana → viân
anga → âng
dono → dôn
menezes → mến
beste → bết
dacs → dác
caus → cáu
eero → ểo
dufay → duày
tepees → tếp
sef → sè
gawk → găk
poro → pổ
dered → để
ches → ché
irresolvable → iresolvable
mossman → mosman
charis → chái
essi → esi
herne → hển
merrymaking → merymaking
possi → posi
vais → vái
tury → tuỷ
irf → ì
rusch → rúch
cooch → côch
coj → cọ
gits → gít
thuja → thụa
gies → gié
causas → cấu
duer → duẻ
dessin → desin
nanga → nâng
osf → ò
ofr → ỏ
taxus → táu
luso → luó
russkoi → ruskoi
harriss → hariss
dessalines → desalines
thirsk → thík
yere → yể
assi → asi
sora → soả
terran → teran
rower → rởe
oroonoko → oronoko
assmann → asmann
lianas → líân
passo → paso
transf → tràn
puro → puỏ
yx → ỹ
sasso → saso
parsees → parses
musts → mút
ufw → ừ
diddle → didle
awwa → awa
serre → sere
buffa → bufa
sasa → sấ
oooh → ooh
verrucous → verucous
nars → ná
garay → gẩy
mongo → mông
conj → cọn
soest → soét
pauw → paư
bowe → bơe
chowk → chơk
marwan → mẩn
thirsts → thít
ojt → ọt
suraj → sụa
ganj → gạn
effi → efi
iooo → ioo
monooxygenase → monoxygenase
urrutia → urutia
chamar → chẩm
baji → bại
lairs → lái
lary → lảy
terram → teram
lwr → lử
cassa → casa
rias → ría
tums → túm
coif → còi
rosslyn → roslyn
seps → sép
gaffe → gafe
parus → páu
homs → hóm
safi → sài
looses → lốe
khoo → khô
posto → pốt
nere → nể
sarris → saris
nessa → nesa
anj → ạn
arna → ẩn
howson → hốn
dorris → doris
peche → pêch
paca → pâc
bowra → bởa
gorst → gót
doms → dóm
ajnr → ản
consignees → consignes
chosa → choá
irritative → iritative
kisch → kích
ajay → ậy
wus → ứu
sarna → sẩn
larix → lãi
etfs → ét
daddies → dadies
kyr → kỷ
canr → cản
weatherproof → weatherprof
thier → thiẻ
benj → bẹn
dojo → dộ
barreling → bareling
aras → ấ
burrus → burus
vereeniging → vereniging
asan → ấn
naja → nậ
lene → lên
irrigable → irigable
paros → páo
dese → dế
bisson → bison
huis → húi
thys → thý
tuns → tún
bienes → biến
maji → mại
oooooooo → oo
gori → gỏi
daan → dân
arrhythmic → arhythmic
pwn → pưn
sero → sẻo
diffi → difi
pufa → pùa
mef → mè
doerr → doer
caffe → cafe
teepee → teepe
fdd → fđ
laf → là
exmoor → exmor
wrc → ửc
nari → nải
guis → gúi
hern → hẻn
russland → rusland
sechs → séch
pois → pói
wps → ứp
dern → dẻn
quist → quít
roon → rôn
daffy → dafy
oems → oém
derridean → deridean
katarina → kkatarina
otr → ỏt
phasors → pháo
aor → ảo
parnas → pấn
pierres → pieres
risse → rise
nier → niẻ
chana → chân
naif → nài
derringer → deringer
atas → ất
macaws → mắc
minx → mĩn
hojo → hộ
darrin → darin
recessional → recsional
goest → goét
oer → oẻ
lisse → lise
doddridge → dodridge
langa → lâng
enfer → ển
hongo → hông
payees → payês
dox → dõ
dosi → dói
pusat → puát
nachr → nảch
dudek → đuek
nees → nế
usaaf → uầ
kier → kiẻ
kamaraj → kkamaraj
unf → ùn
demers → dếm
maur → mảu
parmar → pẩm
barral → baral
passchendaele → paschendaele
basa → bấ
powis → pới
goree → gỏee
nonofficial → nonficial
mero → mẻo
herrin → herin
wisse → uise
aways → ấy
rauf → ràu
mys → mý
coms → cóm
rastafarian → rrastafarian
wos → ướ
somos → sốm
osp → óp
asps → áp
dissects → disects
gowers → gớe
daru → dảu
vins → vín
paro → pảo
coots → cốt
dafydd → dafyd
rur → rủ
asse → ase
nossa → nosa
dosa → doá
gowen → gơen
expellees → expelles
doest → doét
lins → lín
rej → rẹ
vues → vué
ipf → ìp
lecher → lểch
torno → tổn
casta → cất
arrestees → arrestes
hots → hót
buisson → buison
harran → haran
diarrhoeal → diarhoeal
puran → puản
thej → thẹ
momo → môm
marwari → mẩi
necesse → necse
goro → gổ
nwc → nưc
teos → téo
locos → lốc
ays → áy
romo → rôm
lown → lơn
otf → òt
isf → ì
twt → tưt
daws → dắ
offi → ofi
monsoonal → monsonal
bama → bâm
esk → ék
busk → búk
bwr → bử
casu → cáu
missteps → misteps
laus → láu
botox → bỗt
basor → bảo
vasu → váu
thasos → tháo
lasse → lase
borns → bón
paru → pảu
usfs → ú
husak → huák
thefe → thề
roop → rôp
russkogo → ruskogo
execs → ếc
quanah → quânh
panas → pấn
leos → léo
mij → mị
tef → tè
corm → cỏm
defmed → đềm
phips → phíp
musketeer → musketer
suso → suó
chamars → chấm
heuser → hểu
oooooo → oo
corrugation → corugation
denr → dẻn
hif → hì
huw → hư
bex → bẽ
bost → bót
heuer → hểu
pooch → pôch
choosers → chốe
gyr → gỷ
usf → ù
phono → phôn
russkaia → ruskaia
nasca → nấc
thair → thải
rues → rué
coso → cố
dissuading → disuading
ofm → òm
viens → vién
gassner → gasner
gwr → gử
lassa → lasa
hamar → hẩm
nwt → nưt
rosi → rói
dury → duỷ
anr → ản
pesce → pếc
coosa → cốa
chessman → chesman
utf → ùt
dissolutions → disolutions
wilhelmstrasse → uilhelmtase
losch → lóch
rexx → rex
tiefe → tiề
xanax → xẫn
afo → ào
