# Vietnamese Telex Auto-Restore Failures (should not be restored)
# Format: INPUT \t EXPECTED \t ACTUAL
# Total failures: 211

booongs	boóng	boongs
booonsg	boóng	boonsg
booosng	boóng	boosng
buruw	bửu	buruw
chooofng	choòng	choofng
chooonfg	choòng	choonfg
chooongf	choòng	choongf
cooocs	coóc	coocs
cooosc	coóc	coosc
cufuw	cừu	cufuw
cujuw	cựu	cujuw
curuw	cửu	curuw
cusuw	cứu	cusuw
cuxuw	cữu	cuxuw
daafdm	đầm	daafdm
daafdn	đần	daafdn
daaxdm	đẫm	daaxdm
daaxdn	đẫn	daaxdn
dafadm	đầm	dafadm
dafadn	đần	dafadn
dafdam	đầm	dafdam
dafdan	đần	dafdan
dafdm	đàm	dafdm
dafdma	đầm	dafdma
dafdmw	đằm	dafdmw
dafdn	đàn	dafdn
dafdna	đần	dafdna
dafdng	đàng	dafdng
dafdngw	đằng	dafdngw
dafdnh	đành	dafdnh
dafdnw	đằn	dafdnw
dafdnwg	đằng	dafdnwg
dafdwm	đằm	dafdwm
dafdwn	đằn	dafdwn
dafdwng	đằng	dafdwng
dajadm	đậm	dajadm
dajadn	đận	dajadn
dajadp	đập	dajadp
dajadt	đật	dajadt
dardm	đảm	dardm
dardn	đản	dardn
dardng	đảng	dardng
dardngw	đẳng	dardngw
dardnwg	đẳng	dardnwg
dardwng	đẳng	dardwng
dasadm	đấm	dasadm
dasadng	đấng	dasadng
dasadt	đất	dasadt
dawfdm	đằm	dawfdm
dawfdn	đằn	dawfdn
dawfdng	đằng	dawfdng
dawrdng	đẳng	dawrdng
dawxdm	đẵm	dawxdm
dawxdn	đẵn	dawxdn
dawxdng	đẵng	dawxdng
daxadm	đẫm	daxadm
daxadn	đẫn	daxadn
daxdam	đẫm	daxdam
daxdan	đẫn	daxdan
daxdma	đẫm	daxdma
daxdmw	đẵm	daxdmw
daxdna	đẫn	daxdna
daxdng	đãng	daxdng
daxdngw	đẵng	daxdngw
daxdnw	đẵn	daxdnw
daxdnwg	đẵng	daxdnwg
daxdwm	đẵm	daxdwm
daxdwn	đẵn	daxdwn
daxdwng	đẵng	daxdwng
deefdm	đềm	deefdm
deefdn	đền	deefdn
deefdnh	đềnh	deefdnh
deerdnh	đểnh	deerdnh
deexdnh	đễnh	deexdnh
defdem	đềm	defdem
defden	đền	defden
defdenh	đềnh	defdenh
defdm	đèm	defdm
defdme	đềm	defdme
defdn	đèn	defdn
defdne	đền	defdne
defdneh	đềnh	defdneh
defdnhe	đềnh	defdnhe
defedm	đềm	defedm
defedn	đền	defedn
defednh	đềnh	defednh
dejedm	đệm	dejedm
dejedp	đệp	dejedp
derdenh	đểnh	derdenh
derdneh	đểnh	derdneh
derdnhe	đểnh	derdnhe
derednh	đểnh	derednh
desedch	đếch	desedch
desedm	đếm	desedm
desedn	đến	desedn
dexdenh	đễnh	dexdenh
dexdneh	đễnh	dexdneh
dexdnhe	đễnh	dexdnhe
dexednh	đễnh	dexednh
dieefdn	điền	dieefdn
dieerdm	điểm	dieerdm
dieerdn	điển	dieerdn
diefden	điền	diefden
diefdne	điền	diefdne
dierdem	điểm	dierdem
dierden	điển	dierden
dierdme	điểm	dierdme
dierdne	điển	dierdne
difdnh	đình	difdnh
dirdnh	đỉnh	dirdnh
dixdnh	đĩnh	dixdnh
dofdm	đòm	dofdm
dofdmo	đồm	dofdmo
dofdmw	đờm	dofdmw
dofdn	đòn	dofdn
dofdng	đòng	dofdng
dofdngo	đồng	dofdngo
dofdno	đồn	dofdno
dofdnog	đồng	dofdnog
dofdnw	đờn	dofdnw
dofdom	đồm	dofdom
dofdon	đồn	dofdon
dofdong	đồng	dofdong
dofdwm	đờm	dofdwm
dofdwn	đờn	dofdwn
dofodm	đồm	dofodm
dofodn	đồn	dofodn
dofodng	đồng	dofodng
dojodc	độc	dojodc
dojodn	độn	dojodn
dojodng	động	dojodng
dojodp	độp	dojodp
dojodt	đột	dojodt
doofdm	đồm	doofdm
doofdn	đồn	doofdn
doofdng	đồng	doofdng
doordng	đổng	doordng
dordm	đỏm	dordm
dordmw	đởm	dordmw
dordngo	đổng	dordngo
dordnog	đổng	dordnog
dordnw	đởn	dordnw
dordong	đổng	dordong
dordwm	đởm	dordwm
dordwn	đởn	dordwn
dorodng	đổng	dorodng
dosodc	đốc	dosodc
dosodm	đốm	dosodm
dosodn	đốn	dosodn
dosodng	đống	dosodng
dosodp	đốp	dosodp
dosodt	đốt	dosodt
dowfdm	đờm	dowfdm
dowfdn	đờn	dowfdn
dowrdm	đởm	dowrdm
dowrdn	đởn	dowrdn
dufdm	đùm	dufdm
dufdn	đùn	dufdn
dufdng	đùng	dufdng
dufdngw	đừng	dufdngw
dufdnwg	đừng	dufdnwg
dufdwng	đừng	dufdwng
duofdngw	đường	duofdngw
duofdnw	đườn	duofdnw
duofdnwg	đường	duofdnwg
duooxdn	đuỗn	duooxdn
duoxdno	đuỗn	duoxdno
duoxdnw	đưỡn	duoxdnw
duoxdon	đuỗn	duoxdon
durdng	đủng	durdng
duwfdng	đừng	duwfdng
duwofdngw	đường	duwofdngw
duwofdnw	đườn	duwofdnw
duwofdnwg	đường	duwofdnwg
duwofdwn	đườn	duwofdwn
duwofdwng	đường	duwofdwng
duwowfdn	đườn	duwowfdn
duwowfdng	đường	duwowfdng
duwowxdn	đưỡn	duwowxdn
duwoxdnw	đưỡn	duwoxdnw
duwoxdwn	đưỡn	duwoxdwn
duxdng	đũng	duxdng
gooofng	goòng	goofng
gooonfg	goòng	goonfg
gooongf	goòng	goongf
hujuw	hựu	hujuw
huxuw	hữu	huxuw
ira	ỉa	ira
iru	ỉu	iru
khusuw	khứu	khusuw
lose	lóe	lose
lujuw	lựu	lujuw
mems	mém	mems
mooocs	moóc	moocs
mooosc	moóc	moosc
musuw	mứu	musuw
ofa	òa	ofa
ore	ỏe	ore
pacs	pác	pacs
paps	páp	paps
reset	rết	reset
sax	sã	sax
sooocs	soóc	soocs
sooosc	soóc	soosc
suruw	sửu	suruw
tete	têt	tete
tooofng	toòng	toofng
tooonfg	toòng	toonfg
tooongf	toòng	toongf
tujuw	tựu	tujuw
turuw	tửu	turuw
